start_index,end_index,x_top_left,y_top_left,x_bottom_right,y_bottom_right,transcript,box_width,box_height,combined_text,predicted_field
39,39,505,198,525,228,a,20,30,a,OTHER
41,50,537,196,673,231,employee's,136,35,employee's,OTHER
52,57,677,195,748,231,social,71,36,social,OTHER
59,66,752,195,845,231,security,93,36,security,OTHER
68,73,850,196,933,231,number,83,35,number,OTHER
128,132,1586,193,1653,228,"safe,",67,35,"safe,",OTHER
134,142,1659,196,1796,233,accurate.,137,37,accurate.,OTHER
174,178,2090,194,2147,228,visit,57,34,visit,OTHER
180,182,2153,195,2195,229,the,42,34,the,OTHER
184,186,2201,195,2252,230,irs,51,35,irs,OTHER
188,194,2258,193,2365,232,website,107,39,website,OTHER
251,261,697,237,982,278,388-91-5728,285,41,388-91-5728,ssnOfEmployee
352,354,1833,219,1946,263,rev,113,44,rev,OTHER
356,359,1957,220,2047,263,file,90,43,file,OTHER
463,465,1273,242,1325,272,omb,52,30,omb,OTHER
467,469,1330,242,1370,273,no.,40,31,no.,OTHER
471,479,1376,241,1490,274,1545-0008,114,33,1545-0008,OTHER
489,493,1589,242,1676,276,fast!,87,34,fast!,OTHER
495,496,1682,242,1722,279,us,40,37,us,OTHER
536,537,2091,242,2116,275,at,25,33,at,OTHER
539,555,2122,242,2340,279,www.irs.gov/efile,218,37,www.irs.gov/efile,OTHER
558,558,114,288,140,322,b,26,34,b,OTHER
560,567,146,288,250,322,employer,104,34,employer,OTHER
569,582,254,289,389,321,identification,135,32,identification,OTHER
584,589,394,289,476,319,number,82,30,number,OTHER
591,595,482,289,537,317,(ein),55,28,(ein),OTHER
672,677,1447,290,1531,322,"wages,",84,32,"wages,",OTHER
679,683,1536,292,1583,322,"tips,",47,30,"tips,",OTHER
685,689,1587,292,1645,322,other,58,30,other,OTHER
691,702,1649,288,1797,322,compensation,148,34,compensation,OTHER
722,722,1942,283,1970,321,2,28,38,2,OTHER
724,730,2002,289,2085,321,federal,83,32,federal,OTHER
732,737,2089,290,2171,321,income,82,31,income,OTHER
739,741,2175,289,2209,320,tax,34,31,tax,OTHER
743,750,2213,288,2302,319,withheld,89,31,withheld,OTHER
763,772,220,330,477,365,73-1929189,257,35,73-1929189,einEmployerIdentificationNumber
871,876,1477,328,1627,364,219960,150,36,219960,box1WagesTipsAndOtherCompensations
878,880,1635,328,1708,365,.94,73,37,.94,box1WagesTipsAndOtherCompensations
918,922,1979,326,2102,365,75109,123,39,75109,box2FederalIncomeTaxWithheld
924,924,2109,329,2126,366,.,17,37,.,box2FederalIncomeTaxWithheld
926,927,2133,329,2183,367,88,50,38,88,box2FederalIncomeTaxWithheld
931,931,119,379,141,412,c,22,33,c,OTHER
933,942,147,379,264,414,employer's,117,35,employer's,OTHER
944,948,270,381,340,414,"name,",70,33,"name,",OTHER
950,957,346,382,440,414,"address,",94,32,"address,",OTHER
959,961,446,382,485,414,and,39,32,and,OTHER
963,965,491,381,529,414,zip,38,33,zip,OTHER
967,970,535,380,591,414,code,56,34,code,OTHER
1046,1051,1449,383,1517,413,social,68,30,social,OTHER
1053,1060,1521,382,1603,414,security,82,32,security,OTHER
1062,1066,1608,381,1677,414,wages,69,33,wages,OTHER
1097,1102,2004,381,2069,413,social,65,32,social,OTHER
1104,1111,2075,383,2157,413,security,82,30,security,OTHER
1113,1115,2163,383,2196,412,tax,33,29,tax,OTHER
1117,1124,2202,379,2289,411,withheld,87,32,withheld,OTHER
1137,1150,226,425,585,468,campbell-jones,359,43,campbell-jones,employerName
1152,1154,606,425,684,463,llc,78,38,llc,employerName
1246,1252,1476,426,1653,464,156871.,177,38,156871.,box3SocialSecurityWages
1254,1255,1658,428,1700,466,01,42,38,01,box3SocialSecurityWages
1293,1297,1975,426,2102,462,12000,127,36,12000,box4SocialSecurityTaxWithheld
1299,1299,2109,427,2125,463,.,16,36,.,box4SocialSecurityTaxWithheld
1301,1302,2132,428,2174,466,63,42,38,63,box4SocialSecurityTaxWithheld
1314,1317,219,484,322,523,4859,103,39,4859,employerAddressStreet_name
1319,1323,353,484,475,522,jason,122,38,jason,employerAddressStreet_name
1325,1331,504,484,687,523,springs,183,39,springs,employerAddressStreet_name
1333,1337,714,484,843,524,suite,129,40,suite,employerAddressStreet_name
1339,1341,873,485,947,525,702,74,40,702,employerAddressStreet_name
1422,1429,1454,470,1548,503,medicare,94,33,medicare,OTHER
1431,1435,1554,473,1626,504,wages,72,31,wages,OTHER
1437,1439,1632,472,1672,504,and,40,32,and,OTHER
1441,1444,1678,470,1718,503,tips,40,33,tips,OTHER
1470,1470,1943,472,1967,504,6,24,32,6,OTHER
1472,1479,2001,472,2103,502,medicare,102,30,medicare,OTHER
1481,1483,2107,472,2142,502,tax,35,30,tax,OTHER
1485,1492,2146,472,2236,502,withheld,90,30,withheld,OTHER
1614,1619,1477,513,1627,550,232090,150,37,232090,OTHER
1621,1621,1636,513,1652,549,.,16,36,.,OTHER
1623,1624,1658,513,1707,551,32,49,38,32,OTHER
1671,1674,2098,515,2197,551,6730,99,36,6730,OTHER
1676,1676,2204,515,2221,551,.,17,36,.,OTHER
1678,1679,2227,515,2273,551,62,46,36,62,OTHER
1691,1698,215,544,428,585,hallland,213,41,hallland,employerAddressCity
1716,1717,500,543,554,578,de,54,35,de,employerAddressState
1729,1738,636,540,887,581,37834-7387,251,41,37834-7387,employerAddressZip
1858,1863,1449,558,1515,595,social,66,37,social,OTHER
1865,1872,1521,558,1601,595,security,80,37,security,OTHER
1874,1877,1608,559,1656,595,tips,48,36,tips,OTHER
1906,1906,1944,555,1966,586,8,22,31,8,OTHER
1907,1915,2003,558,2102,592,allocated,99,34,allocated,OTHER
1917,1920,2108,558,2153,593,tips,45,35,tips,OTHER
2043,2048,1478,604,1629,641,156871,151,37,156871,OTHER
2050,2050,1634,604,1653,641,.,19,37,.,OTHER
2052,2053,1657,604,1710,643,01,53,39,01,OTHER
2099,2104,2097,606,2252,643,232090,155,37,232090,OTHER
2106,2106,2258,607,2278,643,.,20,36,.,OTHER
2108,2109,2283,606,2332,644,32,49,38,32,OTHER
2112,2112,120,646,142,679,d,22,33,d,OTHER
2114,2120,148,647,224,680,control,76,33,control,OTHER
2122,2127,230,646,319,680,number,89,34,number,OTHER
2276,2277,1933,650,1958,670,10,25,20,10,OTHER
2279,2287,2002,648,2123,679,dependent,121,31,dependent,OTHER
2289,2292,2128,648,2175,679,care,47,31,care,OTHER
2294,2301,2181,647,2273,677,benefits,92,30,benefits,OTHER
2480,2482,2097,696,2167,734,132,70,38,132,OTHER
2485,2485,116,739,138,768,e,22,29,e,OTHER
2487,2496,147,741,272,769,employee's,125,28,employee's,OTHER
2498,2502,276,744,316,769,first,40,25,first,OTHER
2504,2507,320,744,384,769,name,64,25,name,OTHER
2509,2511,388,743,430,769,and,42,26,and,OTHER
2513,2519,434,741,496,769,initial,62,28,initial,OTHER
2531,2534,625,745,675,768,last,50,23,last,OTHER
2536,2539,678,743,741,768,name,63,25,name,OTHER
2587,2591,1300,740,1360,769,suff.,60,29,suff.,OTHER
2593,2594,1378,740,1413,768,11,35,28,11,OTHER
2596,2607,1447,743,1583,772,nonqualified,136,29,nonqualified,OTHER
2609,2613,1588,743,1650,771,plans,62,28,plans,OTHER
2649,2651,1935,736,1979,766,12a,44,30,12a,OTHER
2653,2655,2009,747,2049,770,see,40,23,see,OTHER
2657,2668,2056,744,2195,770,instructions,139,26,instructions,OTHER
2670,2672,2200,743,2234,770,for,34,27,for,OTHER
2674,2676,2237,741,2283,770,box,46,29,box,OTHER
2678,2679,2289,740,2317,769,12,28,29,12,OTHER
2801,2803,1478,803,1543,837,177,65,34,177,OTHER
2863,2866,2099,798,2183,836,5967,84,38,5967,OTHER
2878,2883,218,829,388,865,denise,170,36,denise,employeeName
2901,2905,481,828,626,869,stout,145,41,stout,employeeName
3017,3018,1379,848,1408,876,13,29,28,13,OTHER
3020,3028,1414,849,1501,875,statutory,87,26,statutory,OTHER
3031,3040,1580,850,1672,876,retirement,92,26,retirement,OTHER
3052,3052,1748,856,1754,877,i,6,21,i,OTHER
3054,3063,1758,855,1836,876,hird-party,78,21,hird-party,OTHER
3072,3073,1935,846,1963,874,12,28,28,12,OTHER
3187,3194,1414,879,1498,906,employee,84,27,employee,OTHER
3200,3203,1579,883,1621,906,plan,42,23,plan,OTHER
3219,3222,1745,880,1780,906,sick,35,26,sick,OTHER
3224,3226,1785,879,1825,905,pay,40,26,pay,OTHER
3238,3242,222,908,368,951,66357,146,43,66357,OTHER
3244,3248,397,911,536,953,tapia,139,42,tapia,OTHER
3250,3256,567,912,770,954,springs,203,42,springs,OTHER
3258,3261,798,911,919,954,apt.,121,43,apt.,OTHER
3263,3265,947,910,1034,953,943,87,43,943,OTHER
3352,3352,1595,914,1619,949,x,24,35,x,OTHER
3372,3372,1761,912,1789,953,x,28,41,x,OTHER
3406,3408,2100,914,2162,947,448,62,33,448,OTHER
3420,3430,219,976,538,1019,ashleymouth,319,43,ashleymouth,OTHER
3458,3459,626,977,680,1016,pa,54,39,pa,OTHER
3473,3482,831,974,1117,1018,69126-5360,286,44,69126-5360,OTHER
3520,3521,1378,964,1409,991,14,31,27,14,OTHER
3523,3527,1448,963,1508,992,other,60,29,other,OTHER
3701,3701,2015,1027,2035,1056,c,20,29,c,OTHER
3703,3705,2099,1025,2162,1057,690,63,32,690,OTHER
3881,3881,2015,1130,2042,1166,g,27,36,g,OTHER
3883,3885,2097,1130,2169,1173,547,72,43,547,OTHER
3887,3887,115,1190,138,1224,1,23,34,1,OTHER
3889,3898,148,1189,271,1223,employee's,123,34,employee's,OTHER
3900,3906,277,1189,364,1221,address,87,32,address,OTHER
3908,3910,369,1189,411,1219,and,42,30,and,OTHER
3912,3914,416,1189,453,1218,zip,37,29,zip,OTHER
3916,3919,458,1188,522,1217,code,64,29,code,OTHER
3921,3921,115,1212,136,1244,5,21,32,5,OTHER
3923,3927,148,1208,213,1244,state,65,36,state,OTHER
3929,3938,260,1219,379,1249,employer's,119,30,employer's,OTHER
3940,3944,383,1217,437,1248,state,54,31,state,OTHER
3946,3947,441,1217,467,1248,id,26,31,id,OTHER
3949,3954,472,1215,560,1250,number,88,35,number,OTHER
3977,3978,755,1213,790,1250,16,35,37,16,OTHER
3980,3984,796,1214,850,1250,state,54,36,state,OTHER
3986,3991,857,1214,932,1250,"wages,",75,36,"wages,",OTHER
3993,3997,939,1215,982,1250,"tips,",43,35,"tips,",OTHER
3999,4001,989,1215,1014,1249,etc,25,34,etc,OTHER
4003,4003,1021,1215,1043,1249,.,22,34,.,OTHER
4008,4009,1123,1211,1156,1249,17,33,38,17,OTHER
4011,4015,1162,1212,1215,1250,state,53,38,state,OTHER
4017,4022,1222,1214,1299,1250,income,77,36,income,OTHER
4024,4026,1306,1215,1349,1249,tax,43,34,tax,OTHER
4040,4041,1477,1212,1508,1249,18,31,37,18,OTHER
4043,4047,1514,1213,1572,1250,local,58,37,local,OTHER
4049,4054,1578,1215,1655,1250,"wages,",77,35,"wages,",OTHER
4056,4060,1662,1216,1706,1250,"tips,",44,34,"tips,",OTHER
4062,4065,1713,1216,1758,1249,etc.,45,33,etc.,OTHER
4081,4082,1864,1216,1899,1249,19,35,33,19,OTHER
4084,4088,1903,1216,1961,1248,local,58,32,local,OTHER
4090,4095,1966,1217,2047,1249,income,81,32,income,OTHER
4097,4099,2052,1220,2088,1250,tax,36,30,tax,OTHER
4110,4111,2222,1219,2252,1248,20,30,29,20,OTHER
4113,4120,2259,1219,2340,1248,locality,81,29,locality,OTHER
4122,4125,2345,1219,2410,1248,name,65,29,name,OTHER
4128,4129,126,1263,175,1299,dc,49,36,dc,OTHER
4149,4158,353,1260,603,1301,113-26-326,250,41,113-26-326,OTHER
4183,4189,757,1259,931,1302,118215.,174,43,118215.,box16StateWagesTips
4191,4192,939,1259,979,1302,74,40,43,74,box16StateWagesTips
4214,4217,1122,1260,1219,1303,4792,97,43,4792,box17StateIncomeTax
4219,4221,1226,1260,1304,1303,.26,78,43,.26,box17StateIncomeTax
4246,4254,1474,1259,1712,1304,258168.58,238,45,258168.58,OTHER
4287,4291,1866,1259,1992,1300,37047,126,41,37047,OTHER
4293,4293,1999,1261,2015,1300,.,16,39,.,OTHER
4295,4296,2022,1262,2068,1300,41,46,38,41,OTHER
4316,4321,2222,1269,2334,1300,carlos,112,31,carlos,OTHER
4323,4327,2350,1267,2449,1298,knoll,99,31,knoll,OTHER
4331,4332,126,1349,179,1386,nh,53,37,nh,OTHER
4352,4361,350,1351,610,1388,869-73-936,260,37,869-73-936,OTHER
4386,4392,756,1349,933,1390,100003.,177,41,100003.,OTHER
4394,4395,938,1349,988,1390,14,50,41,14,OTHER
4417,4420,1119,1346,1222,1389,4458,103,43,4458,OTHER
4422,4422,1227,1346,1244,1389,.,17,43,.,OTHER
4424,4425,1249,1346,1307,1389,96,58,43,96,OTHER
4449,4455,1477,1347,1649,1390,254629.,172,43,254629.,OTHER
4457,4458,1655,1347,1704,1389,21,49,42,21,OTHER
4490,4494,1866,1346,1989,1390,39470,123,44,39470,OTHER
4496,4496,1996,1346,2014,1388,.,18,42,.,OTHER
4498,4499,2020,1346,2073,1388,95,53,42,95,OTHER
4519,4527,2219,1355,2375,1395,katherine,156,40,katherine,OTHER
4529,4532,2381,1355,2454,1395,loaf,73,40,loaf,OTHER
4558,4561,365,1402,481,1448,wage,116,46,wage,OTHER
4563,4565,490,1406,574,1449,and,84,43,and,OTHER
4567,4569,582,1406,651,1450,tax,69,44,tax,OTHER
4623,4626,1139,1408,1407,1502,2019,268,94,2019,taxYear
4680,4689,1754,1413,1905,1450,department,151,37,department,OTHER
4691,4692,1912,1416,1935,1450,of,23,34,of,OTHER
4694,4696,1942,1416,1986,1450,the,44,34,the,OTHER
4698,4715,1993,1417,2220,1451,treasury--internal,227,34,treasury--internal,OTHER
4717,4723,2226,1416,2345,1451,revenue,119,35,revenue,OTHER
4725,4731,2351,1415,2456,1450,service,105,35,service,OTHER
4733,4736,99,1470,169,1510,form,70,40,form,OTHER
4738,4740,182,1474,231,1509,w-2,49,35,w-2,OTHER
4751,4759,358,1458,574,1508,statement,216,50,statement,OTHER
4761,4764,101,1510,180,1550,copy,79,40,copy,OTHER
4766,4770,187,1510,272,1549,b--to,85,39,b--to,OTHER
4772,4773,279,1510,319,1548,be,40,38,be,OTHER
4775,4779,326,1510,403,1548,filed,77,38,filed,OTHER
4781,4784,409,1510,476,1547,with,67,37,with,OTHER
4786,4795,482,1510,656,1547,employee's,174,37,employee's,OTHER
4797,4803,663,1511,816,1548,federal,153,37,federal,OTHER
4805,4807,822,1512,878,1549,tax,56,37,tax,OTHER
4809,4814,885,1512,993,1551,return,108,39,return,OTHER
4816,4819,104,1551,162,1586,this,58,35,this,OTHER
4821,4831,168,1551,328,1586,information,160,35,information,OTHER
4833,4834,335,1551,360,1586,is,25,35,is,OTHER
4836,4840,367,1551,447,1586,being,80,35,being,OTHER
4842,4850,453,1551,585,1587,furnished,132,36,furnished,OTHER
4852,4853,592,1551,622,1587,to,30,36,to,OTHER
4855,4857,629,1551,674,1587,the,45,36,the,OTHER
4859,4866,681,1551,788,1588,internal,107,37,internal,OTHER
4868,4874,795,1551,927,1589,revenue,132,38,revenue,OTHER
4876,4883,933,1551,1055,1590,service.,122,39,service.,OTHER
4964,4966,1006,1643,1043,1685,cut,37,42,cut,OTHER
4968,4971,1050,1643,1097,1685,here,47,42,here,OTHER
4973,4973,1105,1644,1119,1684,.,14,40,.,OTHER
4975,4978,1127,1644,1185,1684,keep,58,40,keep,OTHER
4980,4984,1193,1644,1256,1684,lower,63,40,lower,OTHER
4986,4992,1264,1644,1344,1684,portion,80,40,portion,OTHER
4994,4996,1352,1644,1385,1683,for,33,39,for,OTHER
4998,5001,1393,1644,1440,1683,your,47,39,your,OTHER
5003,5009,1448,1644,1531,1683,records,83,39,records,OTHER
5011,5011,1538,1644,1547,1682,.,9,38,.,OTHER
5053,5062,537,1739,671,1776,employee's,134,37,employee's,OTHER
5064,5069,677,1739,744,1777,social,67,38,social,OTHER
5071,5078,751,1739,842,1777,security,91,38,security,OTHER
5080,5085,848,1739,928,1775,number,80,36,number,OTHER
5135,5138,1526,1740,1569,1771,this,43,31,this,OTHER
5140,5150,1574,1740,1695,1773,information,121,33,information,OTHER
5152,5153,1700,1741,1717,1773,is,17,32,is,OTHER
5155,5159,1722,1741,1785,1773,being,63,32,being,OTHER
5161,5169,1790,1741,1888,1774,furnished,98,33,furnished,OTHER
5171,5172,1894,1742,1916,1774,to,22,32,to,OTHER
5174,5176,1922,1742,1956,1774,the,34,32,the,OTHER
5178,5185,1962,1742,2042,1774,internal,80,32,internal,OTHER
5187,5193,2048,1742,2148,1774,revenue,100,32,revenue,OTHER
5195,5202,2154,1741,2246,1774,service.,92,33,service.,OTHER
5204,5205,2252,1741,2264,1774,if,12,33,if,OTHER
5207,5209,2269,1741,2310,1774,you,41,33,you,OTHER
5211,5213,2315,1741,2352,1773,are,37,32,are,OTHER
5215,5222,2357,1741,2452,1773,required,95,32,required,OTHER
5277,5287,697,1781,983,1824,388-91-5728,286,43,388-91-5728,OTHER
5325,5327,1272,1783,1322,1819,omb,50,36,omb,OTHER
5329,5331,1329,1783,1371,1819,no.,42,36,no.,OTHER
5333,5341,1377,1783,1503,1822,1545-0008,126,39,1545-0008,OTHER
5342,5343,1523,1773,1544,1805,to,21,32,to,OTHER
5345,5348,1549,1773,1582,1804,file,33,31,file,OTHER
5350,5350,1588,1773,1600,1804,a,12,31,a,OTHER
5352,5354,1606,1773,1639,1804,tax,33,31,tax,OTHER
5356,5362,1645,1772,1716,1804,"return,",71,32,"return,",OTHER
5364,5364,1722,1772,1736,1804,a,14,32,a,OTHER
5366,5375,1742,1771,1859,1803,negligence,117,32,negligence,OTHER
5377,5383,1864,1771,1944,1803,penalty,80,32,penalty,OTHER
5385,5386,1949,1771,1973,1803,or,24,32,or,OTHER
5388,5392,1978,1771,2034,1803,other,56,32,other,OTHER
5394,5401,2039,1771,2129,1804,sanction,90,33,sanction,OTHER
5403,5405,2134,1771,2178,1804,may,44,33,may,OTHER
5407,5408,2183,1771,2213,1804,be,30,33,be,OTHER
5410,5416,2217,1771,2311,1805,imposed,94,34,imposed,OTHER
5418,5419,2314,1771,2345,1805,on,31,34,on,OTHER
5421,5423,2349,1772,2390,1806,you,41,34,you,OTHER
5425,5426,2393,1772,2416,1806,if,23,34,if,OTHER
5547,5550,1523,1803,1562,1834,this,39,31,this,OTHER
5552,5557,1567,1802,1646,1834,income,79,32,income,OTHER
5559,5560,1651,1802,1670,1834,is,19,32,is,OTHER
5562,5568,1676,1802,1756,1835,taxable,80,33,taxable,OTHER
5570,5572,1762,1802,1802,1835,and,40,33,and,OTHER
5574,5576,1808,1802,1846,1836,you,38,34,you,OTHER
5578,5581,1851,1802,1882,1836,fail,31,34,fail,OTHER
5583,5584,1888,1802,1909,1836,to,21,34,to,OTHER
5586,5591,1914,1802,1979,1837,report,65,35,report,OTHER
5593,5595,1985,1802,2015,1837,it.,30,35,it.,OTHER
5598,5598,115,1830,139,1864,b,24,34,b,OTHER
5600,5607,147,1831,248,1864,employer,101,33,employer,OTHER
5609,5622,254,1831,389,1864,identification,135,33,identification,OTHER
5624,5629,394,1828,471,1863,number,77,35,number,OTHER
5709,5714,1447,1831,1531,1864,"wages,",84,33,"wages,",OTHER
5716,5720,1536,1834,1582,1864,"tips,",46,30,"tips,",OTHER
5722,5726,1588,1834,1644,1864,other,56,30,other,OTHER
5728,5739,1650,1828,1809,1863,compensation,159,35,compensation,OTHER
5762,5768,2001,1831,2085,1864,federal,84,33,federal,OTHER
5770,5775,2091,1831,2170,1864,income,79,33,income,OTHER
5777,5779,2176,1832,2209,1863,tax,33,31,tax,OTHER
5781,5788,2216,1833,2301,1863,withheld,85,30,withheld,OTHER
5801,5810,222,1876,477,1910,73-1929189,255,34,73-1929189,OTHER
5906,5911,1475,1874,1629,1910,219960,154,36,219960,OTHER
5913,5915,1634,1873,1710,1910,.94,76,37,.94,OTHER
5953,5958,1978,1874,2125,1911,75109.,147,37,75109.,OTHER
5960,5961,2132,1875,2183,1910,88,51,35,88,OTHER
5965,5965,118,1920,141,1954,c,23,34,c,OTHER
5967,5976,147,1920,264,1955,employer's,117,35,employer's,OTHER
5978,5982,271,1922,340,1955,"name,",69,33,"name,",OTHER
5984,5991,347,1922,439,1955,"address,",92,33,"address,",OTHER
5993,5995,445,1922,486,1954,and,41,32,and,OTHER
5997,5999,492,1922,528,1953,zip,36,31,zip,OTHER
6001,6004,535,1921,591,1953,code,56,32,code,OTHER
6074,6079,1449,1920,1515,1956,social,66,36,social,OTHER
6081,6088,1522,1919,1603,1954,security,81,35,security,OTHER
6090,6094,1609,1919,1691,1954,wages,82,35,wages,OTHER
6127,6132,2004,1920,2070,1953,social,66,33,social,OTHER
6134,6141,2075,1921,2157,1953,security,82,32,security,OTHER
6143,6145,2162,1921,2194,1953,tax,32,32,tax,OTHER
6147,6154,2200,1919,2287,1954,withheld,87,35,withheld,OTHER
6166,6179,218,1965,587,2006,campbell-jones,369,41,campbell-jones,OTHER
6181,6183,608,1964,683,2005,llc,75,41,llc,OTHER
6272,6277,1477,1964,1629,2003,156871,152,39,156871,OTHER
6279,6279,1636,1964,1650,2004,.,14,40,.,OTHER
6281,6282,1656,1965,1702,2006,01,46,41,01,OTHER
6320,6324,1977,1964,2101,2005,12000,124,41,12000,OTHER
6326,6328,2110,1964,2184,2004,.63,74,40,.63,OTHER
6340,6343,220,2024,323,2064,4859,103,40,4859,OTHER
6345,6349,353,2026,477,2064,jason,124,38,jason,OTHER
6351,6357,504,2027,686,2065,springs,182,38,springs,OTHER
6359,6363,711,2025,842,2066,suite,131,41,suite,OTHER
6365,6367,872,2023,947,2067,702,75,44,702,OTHER
6444,6451,1452,2007,1547,2045,medicare,95,38,medicare,OTHER
6453,6457,1553,2011,1624,2045,wages,71,34,wages,OTHER
6459,6461,1630,2010,1669,2045,and,39,35,and,OTHER
6463,6466,1675,2009,1707,2044,tips,32,35,tips,OTHER
6495,6502,2001,2007,2101,2041,medicare,100,34,medicare,OTHER
6504,6506,2106,2007,2141,2042,tax,35,35,tax,OTHER
6508,6515,2146,2007,2237,2044,withheld,91,37,withheld,OTHER
6633,6638,1476,2055,1630,2094,232090,154,39,232090,OTHER
6640,6640,1636,2056,1654,2094,.,18,38,.,OTHER
6642,6643,1660,2056,1710,2095,32,50,39,32,OTHER
6693,6696,2103,2056,2199,2092,6730,96,36,6730,OTHER
6698,6698,2204,2057,2224,2092,.,20,35,.,OTHER
6700,6701,2228,2055,2282,2092,62,54,37,62,OTHER
6712,6719,215,2086,427,2125,hallland,212,39,hallland,OTHER
6738,6739,500,2083,554,2119,de,54,36,de,OTHER
6751,6760,635,2081,893,2123,37834-7387,258,42,37834-7387,OTHER
6869,6877,2004,2094,2102,2131,allocated,98,37,allocated,OTHER
6879,6882,1609,2096,1648,2134,tips,39,38,tips,OTHER
6997,7002,1449,2097,1514,2132,social,65,35,social,OTHER
7004,7011,1520,2096,1603,2132,security,83,36,security,OTHER
7013,7016,2108,2095,2154,2131,tips,46,36,tips,OTHER
7135,7140,1478,2145,1630,2182,156871,152,37,156871,OTHER
7142,7142,1634,2145,1653,2183,.,19,38,.,OTHER
7144,7145,1657,2144,1710,2183,01,53,39,01,OTHER
7193,7198,2098,2144,2251,2183,232090,153,39,232090,OTHER
7200,7200,2258,2145,2276,2183,.,18,38,.,OTHER
7202,7203,2282,2143,2327,2182,32,45,39,32,OTHER
7206,7206,121,2192,139,2219,d,18,27,d,OTHER
7208,7214,149,2192,227,2222,control,78,30,control,OTHER
7216,7221,232,2192,311,2224,number,79,32,number,OTHER
7364,7365,1933,2190,1961,2213,10,28,23,10,OTHER
7367,7375,2004,2194,2123,2223,dependent,119,29,dependent,OTHER
7377,7380,2128,2193,2177,2222,care,49,29,care,OTHER
7382,7389,2182,2190,2267,2221,benefits,85,31,benefits,OTHER
7400,7405,220,2234,372,2269,679611,152,35,679611,OTHER
7567,7569,2102,2239,2166,2269,132,64,30,132,OTHER
7572,7572,117,2289,135,2315,e,18,26,e,OTHER
7574,7583,148,2286,272,2314,employee's,124,28,employee's,OTHER
7585,7589,276,2285,316,2312,first,40,27,first,OTHER
7591,7594,320,2283,385,2311,name,65,28,name,OTHER
7596,7598,389,2282,431,2311,and,42,29,and,OTHER
7600,7606,434,2281,493,2311,initial,59,30,initial,OTHER
7618,7621,624,2282,673,2313,last,49,31,last,OTHER
7623,7626,677,2282,745,2311,name,68,29,name,OTHER
7674,7678,1300,2279,1359,2310,suff.,59,31,suff.,OTHER
7680,7681,1379,2278,1409,2308,11,30,30,11,OTHER
7683,7694,1447,2283,1583,2313,nonqualified,136,30,nonqualified,OTHER
7696,7700,1588,2283,1655,2311,plans,67,28,plans,OTHER
7730,7732,1935,2283,1976,2309,12a,41,26,12a,OTHER
7734,7736,2007,2283,2051,2311,see,44,28,see,OTHER
7738,7749,2054,2282,2196,2313,instructions,142,31,instructions,OTHER
7751,7753,2200,2282,2233,2313,for,33,31,for,OTHER
7755,7757,2236,2282,2283,2312,box,47,30,box,OTHER
7759,7760,2288,2282,2315,2310,12,27,28,12,OTHER
7881,7883,1478,2336,1544,2369,177,66,33,177,OTHER
7944,7947,2098,2334,2196,2371,5967,98,37,5967,OTHER
7958,7963,216,2367,391,2406,denise,175,39,denise,OTHER
7983,7987,480,2364,625,2405,stout,145,41,stout,OTHER
8099,8100,1377,2386,1408,2417,13,31,31,13,OTHER
8102,8110,1413,2386,1502,2414,statutory,89,28,statutory,OTHER
8112,8121,1578,2386,1688,2413,retirement,110,27,retirement,OTHER
8134,8144,1747,2386,1836,2414,third-party,89,28,third-party,OTHER
8154,8156,1937,2384,1978,2411,12b,41,27,12b,OTHER
8270,8277,1413,2410,1501,2439,employee,88,29,employee,OTHER
8282,8284,1590,2414,1623,2440,lan,33,26,lan,OTHER
8302,8305,1745,2411,1781,2447,sick,36,36,sick,OTHER
8307,8309,1785,2410,1825,2446,pay,40,36,pay,OTHER
8321,8325,221,2434,369,2478,66357,148,44,66357,OTHER
8327,8331,395,2437,538,2480,tapia,143,43,tapia,OTHER
8333,8339,565,2439,772,2481,springs,207,42,springs,OTHER
8341,8344,796,2437,922,2481,apt.,126,44,apt.,OTHER
8346,8348,945,2435,1028,2479,943,83,44,943,OTHER
8434,8434,1594,2439,1619,2474,x,25,35,x,OTHER
8456,8456,1759,2441,1788,2482,x,29,41,x,OTHER
8483,8483,2016,2438,2036,2468,v,20,30,v,OTHER
8485,8488,2078,2430,2165,2473,1448,87,43,1448,OTHER
8499,8509,217,2503,537,2545,ashleymouth,320,42,ashleymouth,OTHER
8537,8538,625,2504,679,2541,pa,54,37,pa,OTHER
8552,8561,829,2496,1116,2543,69126-5360,287,47,69126-5360,OTHER
8600,8601,1378,2489,1413,2522,14,35,33,14,OTHER
8603,8607,1447,2495,1510,2522,other,63,27,other,OTHER
8609,8612,1515,2496,1564,2522,(see,49,26,(see,OTHER
8614,8621,1568,2496,1665,2523,enclosed,97,27,enclosed,OTHER
8623,8628,1670,2496,1741,2523,notice,71,27,notice,OTHER
8630,8631,1746,2496,1767,2522,to,21,26,to,OTHER
8633,8641,1772,2494,1897,2522,employee),125,28,employee),OTHER
8643,8643,1904,2494,1923,2520,|,19,26,|,OTHER
8645,8647,1935,2492,1978,2520,12c,43,28,12c,OTHER
8831,8833,2103,2543,2165,2580,690,62,37,690,OTHER
9000,9002,1936,2595,1977,2622,12d,41,27,12d,OTHER
9176,9176,2019,2649,2042,2683,g,23,34,g,OTHER
9178,9180,2096,2647,2167,2690,547,71,43,547,OTHER
9182,9182,114,2712,135,2742,1,21,30,1,OTHER
9184,9193,149,2712,274,2742,employee's,125,30,employee's,OTHER
9195,9201,278,2711,366,2741,address,88,30,address,OTHER
9203,9205,370,2711,413,2739,and,43,28,and,OTHER
9207,9209,416,2710,457,2738,zip,41,28,zip,OTHER
9211,9214,461,2709,517,2737,code,56,28,code,OTHER
9216,9216,116,2731,135,2762,5,19,31,5,OTHER
9218,9222,148,2728,213,2762,state,65,34,state,OTHER
9224,9233,261,2736,379,2767,employer's,118,31,employer's,OTHER
9235,9239,384,2738,438,2768,state,54,30,state,OTHER
9241,9242,443,2738,468,2768,id,25,30,id,OTHER
9244,9249,473,2735,555,2768,number,82,33,number,OTHER
9272,9273,756,2736,791,2768,16,35,32,16,OTHER
9275,9279,796,2736,850,2768,state,54,32,state,OTHER
9281,9286,855,2736,932,2768,"wages,",77,32,"wages,",OTHER
9288,9292,938,2736,983,2768,"tips,",45,32,"tips,",OTHER
9294,9297,989,2734,1038,2769,etc.,49,35,etc.,OTHER
9304,9305,1125,2735,1155,2770,17,30,35,17,OTHER
9307,9311,1162,2735,1217,2769,state,55,34,state,OTHER
9313,9318,1223,2736,1301,2768,income,78,32,income,OTHER
9320,9322,1307,2736,1344,2767,tax,37,31,tax,OTHER
9335,9336,1478,2735,1511,2768,18,33,33,18,OTHER
9338,9342,1515,2737,1573,2768,local,58,31,local,OTHER
9344,9349,1578,2739,1655,2768,"wages,",77,29,"wages,",OTHER
9351,9355,1661,2738,1707,2768,"tips,",46,30,"tips,",OTHER
9357,9360,1713,2735,1763,2768,etc.,50,33,etc.,OTHER
9376,9377,1866,2738,1899,2770,19,33,32,19,OTHER
9379,9383,1904,2739,1962,2769,local,58,30,local,OTHER
9385,9390,1968,2739,2047,2769,income,79,30,income,OTHER
9392,9394,2053,2740,2090,2770,tax,37,30,tax,OTHER
9405,9406,2221,2735,2252,2766,20,31,31,20,OTHER
9408,9415,2259,2737,2341,2767,locality,82,30,locality,OTHER
9417,9420,2346,2738,2415,2767,name,69,29,name,OTHER
9423,9424,127,2784,174,2813,dc,47,29,dc,OTHER
9444,9453,351,2779,610,2821,113-26-326,259,42,113-26-326,OTHER
9478,9484,754,2778,931,2822,118215.,177,44,118215.,OTHER
9486,9487,938,2778,984,2823,74,46,45,74,OTHER
9510,9513,1121,2775,1219,2824,4792,98,49,4792,OTHER
9515,9515,1226,2778,1241,2824,.,15,46,.,OTHER
9517,9518,1248,2778,1305,2823,26,57,45,26,OTHER
9541,9546,1474,2779,1628,2821,258168,154,42,258168,OTHER
9548,9550,1634,2778,1712,2819,.58,78,41,.58,OTHER
9582,9586,1866,2779,1991,2821,37047,125,42,37047,OTHER
9588,9588,1998,2779,2015,2821,.,17,42,.,OTHER
9590,9591,2022,2780,2072,2823,41,50,43,41,OTHER
9611,9616,2219,2788,2337,2825,carlos,118,37,carlos,OTHER
9618,9622,2350,2787,2445,2823,knoll,95,36,knoll,OTHER
9627,9628,127,2874,175,2903,nh,48,29,nh,OTHER
9647,9656,352,2866,602,2905,869-73-936,250,39,869-73-936,OTHER
9684,9689,755,2865,907,2908,100003,152,43,100003,OTHER
9691,9691,914,2865,931,2905,.,17,40,.,OTHER
9693,9694,938,2865,988,2907,14,50,42,14,OTHER
9713,9716,1122,2864,1220,2908,4458,98,44,4458,OTHER
9718,9718,1228,2864,1243,2908,.,15,44,.,OTHER
9720,9721,1251,2863,1300,2907,96,49,44,96,OTHER
9745,9750,1483,2866,1629,2907,254629,146,41,254629,OTHER
9752,9752,1637,2865,1654,2907,.,17,42,.,OTHER
9754,9755,1660,2865,1711,2908,21,51,43,21,OTHER
9786,9790,1874,2866,1991,2906,39470,117,40,39470,OTHER
9792,9792,1997,2866,2015,2906,.,18,40,.,OTHER
9794,9795,2022,2864,2071,2906,95,49,42,95,OTHER
9814,9822,2224,2878,2372,2913,katherine,148,35,katherine,OTHER
9824,9827,2381,2878,2447,2914,loaf,66,36,loaf,OTHER
9853,9856,369,2924,479,2965,wage,110,41,wage,OTHER
9858,9860,491,2925,575,2965,and,84,40,and,OTHER
9862,9864,582,2923,647,2966,tax,65,43,tax,OTHER
9918,9921,1142,2925,1408,3016,2019,266,91,2019,OTHER
9975,9984,1757,2937,1907,2968,department,150,31,department,OTHER
9986,9987,1911,2937,1937,2967,of,26,30,of,OTHER
9989,9991,1941,2937,1988,2967,the,47,30,the,OTHER
9993,10010,1995,2937,2221,2968,treasury--internal,226,31,treasury--internal,OTHER
10012,10018,2226,2937,2348,2968,revenue,122,31,revenue,OTHER
10020,10026,2354,2937,2452,2969,service,98,32,service,OTHER
10028,10031,100,2985,165,3019,form,65,34,form,OTHER
10033,10035,181,2985,240,3020,w-2,59,35,w-2,OTHER
10045,10053,368,2979,574,3024,statement,206,45,statement,OTHER
10182,10186,1859,2982,1931,3014,"safe,",72,32,"safe,",OTHER
10188,10196,1935,2984,2065,3017,"accurate,",130,33,"accurate,",OTHER
10368,10370,2096,2999,2170,3042,the,74,43,the,OTHER
10372,10372,2181,2999,2213,3041,~,32,42,~,OTHER
10374,10377,2227,2999,2318,3045,file,91,46,file,OTHER
10380,10383,109,3028,182,3059,copy,73,31,copy,OTHER
10385,10385,188,3028,208,3059,c,20,31,c,OTHER
10387,10389,220,3028,273,3059,for,53,31,for,OTHER
10391,10400,279,3028,484,3060,employee's,205,32,employee's,OTHER
10402,10409,493,3028,660,3062,records.,167,34,records.,OTHER
10411,10414,664,3028,737,3063,(see,73,35,(see,OTHER
10416,10421,741,3028,842,3065,notice,101,37,notice,OTHER
10423,10424,846,3028,881,3066,to,35,38,to,OTHER
10533,10537,1863,3016,1953,3048,fast!,90,32,fast!,OTHER
10539,10541,1959,3015,2017,3048,use,58,33,use,OTHER
10543,10550,104,3070,253,3102,employee,149,32,employee,OTHER
10552,10553,259,3070,300,3100,on,41,30,on,OTHER
10555,10557,306,3070,356,3100,the,50,30,the,OTHER
10559,10562,362,3069,438,3100,back,76,31,back,OTHER
10564,10565,444,3068,476,3101,of,32,33,of,OTHER
10567,10570,482,3066,562,3102,copy,80,36,copy,OTHER
10572,10575,568,3065,618,3103,b.)',50,38,b.)',OTHER
