start_index,end_index,x_top_left,y_top_left,x_bottom_right,y_bottom_right,transcript,box_width,box_height,combined_text,predicted_field
39,39,504,937,527,970,a,23,33,a,OTHER
41,50,536,938,672,973,employee's,136,35,employee's,OTHER
52,57,676,940,746,974,social,70,34,social,OTHER
59,66,750,939,843,974,security,93,35,security,OTHER
68,73,848,936,941,974,number,93,38,number,OTHER
127,131,1582,938,1654,972,"safe,",72,34,"safe,",OTHER
133,141,1660,939,1804,976,accurate.,144,37,accurate.,OTHER
156,160,2092,934,2147,972,visit,55,38,visit,OTHER
162,164,2153,937,2197,973,the,44,36,the,OTHER
166,168,2202,938,2253,974,irs,51,36,irs,OTHER
170,176,2259,937,2371,974,website,112,37,website,OTHER
233,243,697,978,985,1020,381-37-6717,288,42,381-37-6717,ssnOfEmployee
321,323,1833,961,1894,1006,rse,61,45,rse,OTHER
325,325,1911,961,1942,1006,~,31,45,~,OTHER
327,330,1956,959,2046,1005,file,90,46,file,OTHER
433,435,1272,981,1324,1015,omb,52,34,omb,OTHER
437,439,1330,980,1371,1016,no.,41,36,no.,OTHER
441,449,1377,979,1491,1015,1545-0008,114,36,1545-0008,OTHER
459,463,1581,982,1676,1017,fast!,95,35,fast!,OTHER
465,466,1681,982,1726,1022,us,45,40,us,OTHER
486,487,2093,984,2117,1019,at,24,35,at,OTHER
489,506,2122,984,2350,1023,www.irs.gov/efile.,228,39,www.irs.gov/efile.,OTHER
508,508,115,1032,137,1065,b,22,33,b,OTHER
510,517,147,1033,248,1065,employer,101,32,employer,OTHER
519,532,254,1034,389,1065,identification,135,31,identification,OTHER
534,539,395,1033,476,1064,number,81,31,number,OTHER
541,545,482,1030,553,1062,(ein),71,32,(ein),OTHER
624,629,1447,1036,1532,1064,"wages,",85,28,"wages,",OTHER
631,635,1537,1037,1583,1064,"tips,",46,27,"tips,",OTHER
637,641,1587,1037,1645,1064,other,58,27,other,OTHER
643,654,1649,1035,1805,1064,compensation,156,29,compensation,OTHER
674,680,2003,1036,2086,1065,federal,83,29,federal,OTHER
682,687,2090,1034,2171,1065,income,81,31,income,OTHER
689,691,2175,1033,2209,1063,tax,34,30,tax,OTHER
693,700,2214,1030,2302,1062,withheld,88,32,withheld,OTHER
710,718,217,1070,451,1106,56-073701,234,36,56-073701,einEmployerIdentificationNumber
821,826,1478,1072,1625,1107,134168,147,35,134168,box1WagesTipsAndOtherCompensations
828,830,1637,1070,1705,1107,.14,68,37,.14,box1WagesTipsAndOtherCompensations
867,872,1977,1070,2127,1107,37067.,150,37,37067.,box2FederalIncomeTaxWithheld
874,875,2133,1070,2184,1107,23,51,37,23,box2FederalIncomeTaxWithheld
878,878,117,1123,140,1156,c,23,33,c,OTHER
880,889,148,1123,264,1158,employer's,116,35,employer's,OTHER
891,895,270,1125,339,1158,"name,",69,33,"name,",OTHER
897,904,346,1124,440,1158,"address,",94,34,"address,",OTHER
906,908,447,1124,486,1158,and,39,34,and,OTHER
910,912,492,1123,529,1157,zip,37,34,zip,OTHER
914,917,535,1121,598,1156,code,63,35,code,OTHER
994,999,1452,1128,1516,1159,social,64,31,social,OTHER
1001,1008,1521,1127,1602,1158,security,81,31,security,OTHER
1010,1014,1608,1127,1687,1160,wages,79,33,wages,OTHER
1044,1049,2006,1127,2071,1155,social,65,28,social,OTHER
1051,1058,2076,1126,2157,1155,security,81,29,security,OTHER
1060,1062,2162,1125,2197,1155,tax,35,30,tax,OTHER
1064,1070,2201,1123,2276,1154,withhel,75,31,withhel,OTHER
1082,1087,218,1168,373,1208,harmon,155,40,harmon,employerName
1089,1093,399,1168,527,1208,group,128,40,group,employerName
1095,1099,556,1168,684,1214,group,128,46,group,employerName
1191,1196,1476,1166,1628,1203,122384,152,37,122384,box3SocialSecurityWages
1198,1200,1636,1166,1705,1207,.39,69,41,.39,box3SocialSecurityWages
1237,1240,1984,1167,2073,1202,9362,89,35,9362,box4SocialSecurityTaxWithheld
1242,1242,2084,1167,2101,1203,.,17,36,.,box4SocialSecurityTaxWithheld
1244,1245,2106,1168,2153,1206,41,47,38,41,box4SocialSecurityTaxWithheld
1363,1370,1447,1210,1547,1247,medicare,100,37,medicare,OTHER
1372,1376,1553,1212,1624,1248,wages,71,36,wages,OTHER
1378,1380,1631,1212,1670,1248,and,39,36,and,OTHER
1382,1385,1676,1211,1717,1247,tips,41,36,tips,OTHER
1413,1420,2002,1210,2102,1245,medicare,100,35,medicare,OTHER
1422,1424,2108,1211,2140,1246,tax,32,35,tax,OTHER
1426,1433,2146,1212,2232,1250,withheld,86,38,withheld,OTHER
1445,1449,217,1225,350,1265,94500,133,40,94500,employerAddressStreet_name
1451,1455,369,1227,507,1263,downs,138,36,downs,employerAddressStreet_name
1457,1461,527,1227,666,1266,mount,139,39,mount,employerAddressStreet_name
1581,1589,1476,1252,1707,1292,169217.39,231,40,169217.39,OTHER
1640,1644,2099,1255,2223,1293,4907.,124,38,4907.,OTHER
1646,1646,2229,1256,2245,1294,3,16,38,3,OTHER
1658,1666,215,1284,448,1323,williston,233,39,williston,employerAddressCity
1668,1669,475,1284,530,1323,ky,55,39,ky,employerAddressState
1671,1680,582,1280,841,1324,20903-5126,259,44,20903-5126,employerAddressZip
1816,1824,2004,1298,2103,1332,allocated,99,34,allocated,OTHER
1826,1829,1608,1300,1650,1336,tips,42,36,tips,OTHER
1947,1952,1450,1301,1515,1334,social,65,33,social,OTHER
1954,1961,1521,1300,1602,1335,security,81,35,security,OTHER
1963,1966,2108,1299,2142,1334,tips,34,35,tips,OTHER
2087,2095,1476,1345,1700,1383,122384.39,224,38,122384.39,OTHER
2145,2151,2098,1344,2275,1384,169217.,177,40,169217.,OTHER
2153,2154,2282,1345,2328,1384,39,46,39,39,OTHER
2157,2157,120,1393,140,1422,d,20,29,d,OTHER
2159,2165,149,1394,226,1424,control,77,30,control,OTHER
2167,2172,231,1396,311,1424,number,80,28,number,OTHER
2272,2283,1450,1394,1568,1426,verification,118,32,verification,OTHER
2285,2288,1573,1391,1630,1420,code,57,29,code,OTHER
2317,2318,1933,1395,1958,1419,10,25,24,10,OTHER
2320,2328,2003,1394,2125,1423,dependent,122,29,dependent,OTHER
2330,2333,2129,1394,2178,1423,care,49,29,care,OTHER
2335,2342,2182,1393,2264,1423,benefits,82,30,benefits,OTHER
2355,2355,217,1437,238,1464,8,21,27,8,OTHER
2521,2523,2097,1440,2164,1474,282,67,34,282,OTHER
2526,2526,118,1486,137,1514,e,19,28,e,OTHER
2528,2537,147,1486,272,1514,employee's,125,28,employee's,OTHER
2539,2543,276,1487,317,1512,first,41,25,first,OTHER
2545,2548,321,1486,386,1512,name,65,26,name,OTHER
2550,2552,390,1485,431,1511,and,41,26,and,OTHER
2554,2560,435,1483,487,1510,initial,52,27,initial,OTHER
2573,2576,626,1485,675,1511,last,49,26,last,OTHER
2578,2581,678,1485,744,1511,name,66,26,name,OTHER
2628,2632,1301,1479,1360,1512,suff.,59,33,suff.,OTHER
2634,2635,1379,1478,1412,1509,11,33,31,11,OTHER
2637,2648,1450,1484,1581,1513,nonqualified,131,29,nonqualified,OTHER
2650,2654,1586,1484,1654,1513,plans,68,29,plans,OTHER
2686,2688,1934,1483,1974,1513,12a,40,30,12a,OTHER
2690,2692,2008,1485,2050,1511,see,42,26,see,OTHER
2694,2705,2055,1485,2196,1512,instructions,141,27,instructions,OTHER
2707,2709,2200,1484,2233,1512,for,33,28,for,OTHER
2711,2713,2237,1484,2285,1512,box,48,28,box,OTHER
2715,2716,2290,1483,2310,1511,12,20,28,12,OTHER
2839,2841,1478,1544,1550,1574,135,72,30,135,OTHER
2896,2899,2097,1538,2197,1577,9769,100,39,9769,OTHER
2911,2917,217,1572,414,1611,william,197,39,william,employeeName
2919,2922,479,1574,593,1613,cruz,114,39,cruz,employeeName
3062,3064,1936,1580,1974,1621,12b,38,41,12b,OTHER
3177,3178,1379,1592,1410,1620,13,31,28,13,OTHER
3180,3188,1415,1590,1503,1619,statutory,88,29,statutory,OTHER
3191,3200,1581,1594,1684,1622,retirement,103,28,retirement,OTHER
3208,3218,1745,1594,1842,1621,third-party,97,27,third-party,OTHER
3334,3340,1413,1617,1486,1640,employe,73,23,employe,OTHER
3345,3348,1580,1622,1622,1652,plan,42,30,plan,OTHER
3362,3365,1746,1618,1783,1642,sick,37,24,sick,OTHER
3367,3369,1784,1620,1824,1644,pay,40,24,pay,OTHER
3380,3382,220,1653,310,1695,357,90,42,357,OTHER
3384,3390,333,1655,536,1696,clinton,203,41,clinton,OTHER
3392,3399,570,1654,798,1696,turnpike,228,42,turnpike,OTHER
3496,3496,1596,1656,1617,1688,x,21,32,x,OTHER
3540,3540,2017,1657,2033,1681,w,16,24,w,OTHER
3545,3547,2099,1656,2168,1692,442,69,36,442,OTHER
3559,3568,218,1719,511,1760,autumnland,293,41,autumnland,OTHER
3570,3571,535,1717,595,1759,ak,60,42,ak,OTHER
3600,3609,682,1717,975,1761,57290-3856,293,44,57290-3856,OTHER
3660,3661,1378,1706,1410,1738,14,32,32,14,OTHER
3663,3667,1448,1704,1504,1734,other,56,30,other,OTHER
3710,3711,1936,1705,1957,1736,12,21,31,12,OTHER
3713,3713,1962,1704,1975,1735,c,13,31,c,OTHER
3884,3884,2018,1772,2035,1794,z,17,22,z,OTHER
3894,3896,2097,1766,2170,1801,134,73,35,134,OTHER
4074,4076,2097,1874,2158,1911,358,61,37,358,OTHER
4078,4078,115,1933,135,1964,1,20,31,1,OTHER
4080,4089,149,1931,273,1963,employee's,124,32,employee's,OTHER
4091,4097,279,1931,366,1960,address,87,29,address,OTHER
4099,4101,371,1931,412,1960,and,41,29,and,OTHER
4103,4105,417,1931,454,1960,zip,37,29,zip,OTHER
4107,4110,459,1932,520,1962,code,61,30,code,OTHER
4113,4114,110,1952,137,1987,15,27,35,15,OTHER
4116,4121,148,1950,211,1989,statel,63,39,statel,OTHER
4123,4132,260,1961,378,1992,employer's,118,31,employer's,OTHER
4134,4138,384,1960,436,1992,state,52,32,state,OTHER
4140,4141,442,1960,468,1992,id,26,32,id,OTHER
4143,4148,474,1959,560,1995,number,86,36,number,OTHER
4172,4173,755,1956,789,1993,16,34,37,16,OTHER
4175,4179,796,1956,849,1994,state,53,38,state,OTHER
4181,4186,855,1958,932,1994,"wages,",77,36,"wages,",OTHER
4188,4192,938,1959,985,1994,"tips,",47,35,"tips,",OTHER
4194,4197,991,1960,1028,1994,etc.,37,34,etc.,OTHER
4201,4202,1122,1956,1155,1994,17,33,38,17,OTHER
4204,4208,1162,1956,1215,1995,state,53,39,state,OTHER
4210,4215,1222,1956,1300,1994,income,78,38,income,OTHER
4217,4219,1306,1955,1348,1993,tax,42,38,tax,OTHER
4230,4231,1480,1955,1508,1994,18,28,39,18,OTHER
4233,4237,1515,1956,1572,1995,local,57,39,local,OTHER
4239,4244,1579,1958,1654,1995,"wages,",75,37,"wages,",OTHER
4246,4250,1661,1958,1707,1995,"tips,",46,37,"tips,",OTHER
4252,4255,1713,1957,1761,1994,etc.,48,37,etc.,OTHER
4268,4269,1864,1957,1897,1993,19,33,36,19,OTHER
4271,4275,1902,1958,1961,1993,local,59,35,local,OTHER
4277,4282,1966,1959,2045,1993,income,79,34,income,OTHER
4284,4286,2049,1962,2087,1993,tax,38,31,tax,OTHER
4298,4299,2227,1960,2251,1994,20,24,34,20,OTHER
4301,4308,2258,1960,2339,1994,locality,81,34,locality,OTHER
4310,4313,2344,1960,2416,1993,name,72,33,name,OTHER
4318,4319,130,1999,180,2036,ca,50,37,ca,OTHER
4334,4343,353,2001,608,2039,700-90-435,255,38,700-90-435,OTHER
4375,4379,754,1999,881,2042,67220,127,43,67220,box16StateWagesTips
4381,4381,889,2001,903,2042,.,14,41,.,box16StateWagesTips
4383,4384,910,2002,964,2043,02,54,41,02,box16StateWagesTips
4404,4407,1125,2001,1220,2043,3481,95,42,3481,box17StateIncomeTax
4409,4409,1228,2001,1246,2044,.,18,43,.,box17StateIncomeTax
4411,4412,1254,2001,1302,2046,72,48,45,72,box17StateIncomeTax
4433,4438,1477,1998,1629,2043,127229,152,45,127229,OTHER
4440,4440,1636,2001,1652,2043,.,16,42,.,OTHER
4442,4443,1660,2002,1713,2044,12,53,42,12,OTHER
4471,4478,1865,2002,2069,2041,24956.87,204,39,24956.87,OTHER
4500,4506,2217,2010,2351,2040,hoffman,134,30,hoffman,OTHER
4508,4511,2372,2008,2448,2040,loaf,76,32,loaf,OTHER
4515,4516,127,2091,179,2123,ma,52,32,ma,OTHER
4536,4545,353,2088,610,2127,720-02-135,257,39,720-02-135,OTHER
4570,4574,753,2089,881,2129,68458,128,40,68458,OTHER
4576,4576,889,2089,902,2129,.,13,40,.,OTHER
4578,4579,909,2089,952,2129,52,43,40,52,OTHER
4603,4606,1119,2086,1219,2131,2435,100,45,2435,OTHER
4608,4608,1226,2085,1245,2129,.,19,44,.,OTHER
4610,4611,1252,2084,1302,2129,17,50,45,17,OTHER
4632,4637,1476,2088,1628,2129,102005,152,41,102005,OTHER
4639,4639,1635,2088,1654,2127,.,19,39,.,OTHER
4641,4642,1661,2088,1701,2127,78,40,39,78,OTHER
4670,4674,1865,2088,1991,2128,17501,126,40,17501,OTHER
4676,4676,1999,2089,2014,2128,.,15,39,.,OTHER
4678,4679,2022,2090,2063,2129,46,41,39,46,OTHER
4699,4706,2225,2096,2364,2131,jennifer,139,35,jennifer,OTHER
4708,4711,2375,2097,2444,2135,oval,69,38,oval,OTHER
4737,4740,365,2146,482,2190,wage,117,44,wage,OTHER
4742,4744,488,2146,573,2190,and,85,44,and,OTHER
4746,4748,580,2147,650,2190,tax,70,43,tax,OTHER
4802,4805,1143,2149,1407,2242,2018,264,93,2018,taxYear
4856,4865,1756,2156,1904,2192,department,148,36,department,OTHER
4867,4868,1910,2158,1934,2192,of,24,34,of,OTHER
4870,4872,1940,2158,1988,2192,the,48,34,the,OTHER
4874,4891,1994,2158,2219,2192,treasury--internal,225,34,treasury--internal,OTHER
4893,4899,2225,2158,2346,2192,revenue,121,34,revenue,OTHER
4901,4907,2351,2157,2451,2192,service,100,35,service,OTHER
4909,4912,104,2212,166,2250,form,62,38,form,OTHER
4914,4916,182,2214,241,2250,w-2,59,36,w-2,OTHER
4927,4935,361,2203,575,2249,statement,214,46,statement,OTHER
4938,4941,108,2254,180,2291,copy,72,37,copy,OTHER
4943,4947,187,2254,271,2291,b--to,84,37,b--to,OTHER
4949,4950,278,2255,321,2291,be,43,36,be,OTHER
4952,4956,327,2255,402,2291,filed,75,36,filed,OTHER
4958,4961,408,2256,475,2291,with,67,35,with,OTHER
4963,4972,482,2256,657,2292,employee's,175,36,employee's,OTHER
4974,4980,664,2257,817,2293,federal,153,36,federal,OTHER
4982,4984,824,2257,876,2293,tax,52,36,tax,OTHER
4986,4991,883,2257,989,2294,return,106,37,return,OTHER
4993,4996,103,2296,162,2330,this,59,34,this,OTHER
4998,5008,167,2297,327,2330,information,160,33,information,OTHER
5010,5011,333,2298,360,2330,is,27,32,is,OTHER
5013,5017,367,2298,447,2330,being,80,32,being,OTHER
5019,5027,453,2298,586,2330,furnished,133,32,furnished,OTHER
5029,5030,592,2298,621,2330,to,29,32,to,OTHER
5032,5034,628,2298,675,2331,the,47,33,the,OTHER
5036,5043,681,2298,790,2331,internal,109,33,internal,OTHER
5045,5051,796,2297,927,2331,revenue,131,34,revenue,OTHER
5053,5060,933,2297,1045,2331,service.,112,34,service.,OTHER
