start_index,end_index,x_top_left,y_top_left,x_bottom_right,y_bottom_right,transcript,box_width,box_height,combined_text,predicted_field
39,39,504,937,527,970,a,23,33,a,OTHER
41,50,536,938,671,972,employee's,135,34,employee's,OTHER
52,57,676,941,746,973,social,70,32,social,OTHER
59,66,752,942,843,973,security,91,31,security,OTHER
68,73,848,941,935,972,number,87,31,number,OTHER
127,131,1583,938,1655,972,"safe,",72,34,"safe,",OTHER
133,141,1661,939,1806,976,accurate.,145,37,accurate.,OTHER
155,159,2092,934,2147,971,visit,55,37,visit,OTHER
161,163,2153,937,2196,973,the,43,36,the,OTHER
165,167,2202,938,2253,974,irs,51,36,irs,OTHER
169,175,2258,937,2370,974,website,112,37,website,OTHER
232,242,701,979,979,1017,482-93-5189,278,38,482-93-5189,ssnOfEmployee
320,321,1833,961,1894,1006,re,61,45,re,OTHER
323,323,1913,961,1942,1006,~,29,45,~,OTHER
325,328,1956,959,2045,1005,file,89,46,file,OTHER
430,432,1272,980,1325,1015,omb,53,35,omb,OTHER
434,436,1331,980,1370,1016,no.,39,36,no.,OTHER
438,446,1376,979,1492,1016,1545-0008,116,37,1545-0008,OTHER
457,461,1581,982,1676,1017,fast!,95,35,fast!,OTHER
463,464,1681,982,1725,1021,us,44,39,us,OTHER
483,484,2091,984,2116,1019,at,25,35,at,OTHER
486,503,2121,984,2351,1022,www.irs.gov/efile.,230,38,www.irs.gov/efile.,OTHER
505,505,115,1032,137,1064,b,22,32,b,OTHER
507,514,148,1033,249,1064,employer,101,31,employer,OTHER
516,529,254,1034,387,1064,identification,133,30,identification,OTHER
531,536,393,1033,477,1064,number,84,31,number,OTHER
538,542,483,1031,553,1063,(ein),70,32,(ein),OTHER
620,625,1447,1036,1533,1065,"wages,",86,29,"wages,",OTHER
627,631,1538,1037,1585,1065,"tips,",47,28,"tips,",OTHER
633,637,1589,1037,1645,1064,other,56,27,other,OTHER
639,650,1650,1035,1807,1064,compensation,157,29,compensation,OTHER
672,678,2003,1036,2087,1064,federal,84,28,federal,OTHER
680,685,2092,1035,2170,1064,income,78,29,income,OTHER
687,689,2175,1034,2210,1064,tax,35,30,tax,OTHER
691,698,2214,1032,2303,1062,withheld,89,30,withheld,OTHER
709,718,218,1071,480,1108,88-1679621,262,37,88-1679621,einEmployerIdentificationNumber
818,823,1477,1072,1628,1105,233867,151,33,233867,box1WagesTipsAndOtherCompensations
825,827,1636,1072,1704,1105,.03,68,33,.03,box1WagesTipsAndOtherCompensations
866,870,1976,1071,2105,1107,81441,129,36,81441,box2FederalIncomeTaxWithheld
872,872,2111,1071,2126,1107,.,15,36,.,box2FederalIncomeTaxWithheld
874,874,2133,1071,2148,1107,8,15,36,8,box2FederalIncomeTaxWithheld
877,877,118,1122,140,1156,c,22,34,c,OTHER
879,888,148,1123,265,1157,employer's,117,34,employer's,OTHER
890,894,270,1125,339,1158,"name,",69,33,"name,",OTHER
896,903,345,1125,439,1158,"address,",94,33,"address,",OTHER
905,907,445,1125,485,1158,and,40,33,and,OTHER
909,911,491,1124,528,1157,zip,37,33,zip,OTHER
913,916,534,1123,583,1157,code,49,34,code,OTHER
992,997,1451,1126,1516,1158,social,65,32,social,OTHER
999,1006,1521,1125,1603,1159,security,82,34,security,OTHER
1008,1012,1609,1125,1687,1159,wages,78,34,wages,OTHER
1044,1049,2006,1128,2071,1157,social,65,29,social,OTHER
1051,1058,2076,1126,2157,1157,security,81,31,security,OTHER
1060,1062,2162,1125,2197,1155,tax,35,30,tax,OTHER
1064,1071,2201,1122,2285,1154,withheld,84,32,withheld,OTHER
1083,1092,219,1165,485,1207,"christian,",266,42,"christian,",employerName
1094,1099,504,1167,661,1207,turner,157,40,turner,employerName
1101,1103,686,1167,765,1207,and,79,40,and,employerName
1105,1110,785,1165,947,1207,moreno,162,42,moreno,employerName
1112,1114,972,1163,1050,1206,llc,78,43,llc,employerName
1191,1198,1475,1167,1685,1210,242349.1,210,43,242349.1,box3SocialSecurityWages
1239,1243,1977,1167,2099,1201,18539,122,34,18539,box4SocialSecurityTaxWithheld
1245,1247,2111,1167,2180,1208,.71,69,41,.71,box4SocialSecurityTaxWithheld
1259,1261,219,1224,300,1265,796,81,41,796,employerAddressStreet_name
1263,1269,320,1224,508,1265,charles,188,41,charles,employerAddressStreet_name
1271,1275,529,1227,656,1267,views,127,40,views,employerAddressStreet_name
1366,1373,1461,1209,1547,1248,medicare,86,39,medicare,OTHER
1375,1379,1553,1212,1624,1248,wages,71,36,wages,OTHER
1381,1383,1631,1212,1669,1247,and,38,35,and,OTHER
1385,1388,1676,1210,1714,1245,tips,38,35,tips,OTHER
1416,1423,2002,1209,2100,1245,medicare,98,36,medicare,OTHER
1425,1427,2107,1210,2139,1246,tax,32,36,tax,OTHER
1429,1436,2145,1212,2231,1247,withheld,86,35,withheld,OTHER
1555,1560,1476,1250,1629,1297,286051,153,47,286051,OTHER
1562,1562,1635,1256,1650,1297,.,15,41,.,OTHER
1564,1564,1656,1256,1681,1298,2,25,42,2,OTHER
1615,1618,2097,1253,2199,1293,8295,102,40,8295,OTHER
1620,1620,2205,1256,2224,1293,.,19,37,.,OTHER
1622,1623,2230,1255,2279,1292,48,49,37,48,OTHER
1635,1638,217,1285,321,1326,lake,104,41,lake,employerAddressCity
1640,1648,344,1285,583,1326,ericabury,239,41,ericabury,employerAddressCity
1650,1651,609,1284,663,1326,ca,54,42,ca,employerAddressState
1653,1662,689,1279,941,1326,49286-7508,252,47,49286-7508,employerAddressZip
1793,1801,2003,1297,2104,1332,allocated,101,35,allocated,OTHER
1803,1806,1608,1299,1651,1335,tips,43,36,tips,OTHER
1924,1929,1451,1302,1515,1336,social,64,34,social,OTHER
1931,1938,1521,1300,1601,1335,security,80,35,security,OTHER
1940,1943,2109,1297,2155,1332,tips,46,35,tips,OTHER
2063,2069,1475,1343,1653,1385,242349.,178,42,242349.,OTHER
2071,2071,1660,1344,1677,1386,1,17,42,1,OTHER
2122,2129,2098,1345,2296,1384,286051.2,198,39,286051.2,OTHER
2132,2132,120,1391,141,1423,d,21,32,d,OTHER
2134,2140,149,1392,225,1424,control,76,32,control,OTHER
2142,2147,231,1395,309,1424,number,78,29,number,OTHER
2246,2257,1450,1393,1569,1425,verification,119,32,verification,OTHER
2259,2262,1575,1390,1635,1422,code,60,32,code,OTHER
2293,2294,1933,1395,1960,1421,10,27,26,10,OTHER
2296,2304,2004,1394,2124,1423,dependent,120,29,dependent,OTHER
2306,2309,2129,1393,2176,1423,care,47,30,care,OTHER
2311,2318,2181,1391,2271,1421,benefits,90,30,benefits,OTHER
2331,2332,218,1437,253,1467,64,35,30,64,OTHER
2496,2498,2099,1441,2167,1472,102,68,31,102,OTHER
2501,2501,118,1485,139,1515,e,21,30,e,OTHER
2503,2512,148,1486,270,1515,employee's,122,29,employee's,OTHER
2514,2518,275,1486,316,1513,first,41,27,first,OTHER
2520,2523,321,1485,383,1512,name,62,27,name,OTHER
2525,2527,388,1484,429,1511,and,41,27,and,OTHER
2529,2535,434,1483,487,1510,initial,53,27,initial,OTHER
2547,2550,626,1486,673,1515,last,47,29,last,OTHER
2552,2555,678,1485,742,1512,name,64,27,name,OTHER
2602,2606,1300,1478,1360,1512,suff.,60,34,suff.,OTHER
2608,2609,1379,1478,1412,1510,11,33,32,11,OTHER
2611,2622,1450,1483,1582,1512,nonqualified,132,29,nonqualified,OTHER
2624,2628,1587,1484,1655,1512,plans,68,28,plans,OTHER
2662,2664,1933,1485,1980,1513,12a,47,28,12a,OTHER
2666,2668,2006,1484,2050,1512,see,44,28,see,OTHER
2670,2681,2055,1484,2194,1512,instructions,139,28,instructions,OTHER
2683,2685,2199,1484,2232,1511,for,33,27,for,OTHER
2687,2689,2236,1484,2286,1512,box,50,28,box,OTHER
2691,2692,2290,1484,2310,1512,12,20,28,12,OTHER
2813,2815,1478,1542,1547,1571,201,69,29,201,OTHER
2861,2862,2003,1541,2052,1577,aa,49,36,aa,OTHER
2864,2867,2099,1541,2194,1575,6345,95,34,6345,OTHER
2879,2886,227,1574,449,1613,jennifer,222,39,jennifer,employeeName
2888,2892,477,1574,616,1613,marsh,139,39,marsh,employeeName
3012,3022,1745,1594,1844,1621,third-party,99,27,third-party,OTHER
3031,3033,1934,1583,1975,1621,126,41,38,126,OTHER
3145,3146,1378,1591,1408,1621,13,30,30,13,OTHER
3148,3156,1414,1590,1503,1619,statutory,89,29,statutory,OTHER
3158,3167,1581,1593,1683,1621,retirement,102,28,retirement,OTHER
3282,3288,1413,1618,1490,1642,employe,77,24,employe,OTHER
3292,3295,1577,1622,1624,1653,plan,47,31,plan,OTHER
3312,3315,1746,1618,1784,1642,sick,38,24,sick,OTHER
3317,3319,1786,1620,1825,1644,pay,39,24,pay,OTHER
3331,3335,221,1652,372,1696,71297,151,44,71297,OTHER
3337,3344,386,1654,628,1696,michelle,242,42,michelle,OTHER
3346,3350,659,1654,803,1696,inlet,144,42,inlet,OTHER
3500,3502,2100,1656,2166,1692,720,66,36,720,OTHER
3514,3517,217,1719,338,1763,port,121,44,port,OTHER
3519,3528,369,1719,653,1763,jamesmouth,284,44,jamesmouth,OTHER
3530,3531,680,1719,747,1762,ut,67,43,ut,OTHER
3533,3542,774,1719,1059,1762,94803-3857,285,43,94803-3857,OTHER
3614,3615,1377,1705,1411,1738,14,34,33,14,OTHER
3617,3621,1448,1704,1505,1734,other,57,30,other,OTHER
3666,3667,1935,1705,1957,1736,12,22,31,12,OTHER
3669,3669,1961,1704,1975,1735,c,14,31,c,OTHER
3840,3841,2003,1770,2050,1799,aa,47,29,aa,OTHER
3843,3845,2099,1765,2174,1799,305,75,34,305,OTHER
4009,4011,1935,1802,1975,1837,12d,40,35,12d,OTHER
4183,4184,1999,1877,2048,1911,hh,49,34,hh,OTHER
4186,4188,2097,1876,2161,1912,908,64,36,908,OTHER
4190,4190,115,1933,135,1964,1,20,31,1,OTHER
4192,4201,148,1931,274,1963,employee's,126,32,employee's,OTHER
4203,4209,279,1930,366,1961,address,87,31,address,OTHER
4211,4213,371,1930,413,1960,and,42,30,and,OTHER
4215,4217,418,1931,456,1961,zip,38,30,zip,OTHER
4219,4222,461,1932,520,1962,code,59,30,code,OTHER
4224,4225,110,1952,137,1988,15,27,36,15,OTHER
4227,4231,149,1950,213,1990,state,64,40,state,OTHER
4233,4242,260,1960,379,1992,employer's,119,32,employer's,OTHER
4244,4248,384,1960,438,1993,state,54,33,state,OTHER
4250,4251,443,1959,468,1994,id,25,35,id,OTHER
4253,4258,473,1956,564,1995,number,91,39,number,OTHER
4283,4284,756,1955,789,1995,16,33,40,16,OTHER
4286,4290,797,1956,850,1996,state,53,40,state,OTHER
4292,4297,857,1958,930,1996,"wages,",73,38,"wages,",OTHER
4299,4303,937,1957,983,1996,"tips,",46,39,"tips,",OTHER
4305,4308,990,1955,1036,1994,etc.,46,39,etc.,OTHER
4312,4313,1122,1956,1156,1996,17,34,40,17,OTHER
4315,4319,1163,1957,1215,1996,state,52,39,state,OTHER
4321,4326,1221,1956,1300,1995,income,79,39,income,OTHER
4328,4330,1305,1955,1344,1994,tax,39,39,tax,OTHER
4342,4343,1480,1954,1509,1994,18,29,40,18,OTHER
4345,4349,1515,1956,1571,1995,local,56,39,local,OTHER
4351,4356,1578,1958,1654,1995,"wages,",76,37,"wages,",OTHER
4358,4362,1661,1958,1707,1995,"tips,",46,37,"tips,",OTHER
4364,4367,1713,1957,1760,1994,etc.,47,37,etc.,OTHER
4381,4382,1865,1958,1898,1994,19,33,36,19,OTHER
4384,4388,1903,1958,1961,1994,local,58,36,local,OTHER
4390,4395,1967,1960,2047,1994,income,80,34,income,OTHER
4397,4399,2052,1962,2080,1993,tax,28,31,tax,OTHER
4412,4413,2221,1961,2252,1993,20,31,32,20,OTHER
4415,4422,2258,1960,2341,1993,locality,83,33,locality,OTHER
4424,4427,2346,1960,2414,1993,name,68,33,name,OTHER
4431,4432,131,1999,183,2035,ct,52,36,ct,OTHER
4447,4456,352,1998,612,2039,901-64-873,260,41,901-64-873,OTHER
4488,4494,754,2001,929,2041,116725.,175,40,116725.,box16StateWagesTips
4496,4497,935,2001,990,2041,06,55,40,06,box16StateWagesTips
4517,4521,1121,1999,1245,2044,11792,124,45,11792,box17StateIncomeTax
4523,4523,1253,1999,1268,2040,.,15,41,.,box17StateIncomeTax
4525,4526,1276,1998,1327,2040,03,51,42,03,OTHER
4546,4551,1474,2000,1629,2042,246212,155,42,246212,OTHER
4553,4553,1635,2000,1654,2041,.,19,41,.,OTHER
4555,4556,1659,2001,1713,2041,19,54,40,19,OTHER
4586,4593,1864,2002,2074,2041,28146.76,210,39,28146.76,OTHER
4617,4621,2224,2009,2324,2043,betty,100,34,betty,OTHER
4623,4627,2344,2009,2441,2042,lakes,97,33,lakes,OTHER
4632,4633,130,2091,175,2122,sd,45,31,sd,OTHER
4652,4661,352,2089,609,2126,259-58-646,257,37,259-58-646,OTHER
4686,4691,754,2087,906,2133,117955,152,46,117955,OTHER
4693,4693,913,2087,931,2130,.,18,43,.,OTHER
4695,4696,938,2087,984,2131,72,46,44,72,OTHER
4718,4722,1119,2088,1247,2131,9628.,128,43,9628.,OTHER
4724,4725,1253,2088,1299,2129,93,46,41,93,OTHER
4747,4753,1476,2089,1654,2128,193599.,178,39,193599.,OTHER
4755,4756,1660,2089,1700,2126,36,40,37,36,OTHER
4787,4792,1866,2089,2013,2130,24749.,147,41,24749.,OTHER
4794,4795,2021,2089,2069,2129,14,48,40,14,OTHER
4819,4823,2225,2098,2311,2131,kevin,86,33,kevin,OTHER
4825,4831,2323,2098,2451,2135,gardens,128,37,gardens,OTHER
4857,4860,365,2147,482,2189,wage,117,42,wage,OTHER
4862,4864,489,2147,575,2190,and,86,43,and,OTHER
4866,4868,581,2148,650,2190,tax,69,42,tax,OTHER
4921,4924,1137,2149,1409,2243,2018,272,94,2018,taxYear
4977,4986,1757,2157,1905,2192,department,148,35,department,OTHER
4988,4989,1911,2158,1935,2192,of,24,34,of,OTHER
4991,4993,1941,2158,1986,2192,the,45,34,the,OTHER
4995,5012,1992,2158,2219,2192,treasury--internal,227,34,treasury--internal,OTHER
5014,5020,2225,2157,2344,2192,revenue,119,35,revenue,OTHER
5022,5028,2349,2156,2451,2192,service,102,36,service,OTHER
5030,5033,103,2213,166,2249,form,63,36,form,OTHER
5035,5037,181,2214,239,2249,w-2,58,35,w-2,OTHER
5048,5056,361,2203,575,2249,statement,214,46,statement,OTHER
5059,5062,108,2254,182,2291,copy,74,37,copy,OTHER
5064,5068,188,2255,272,2291,b--to,84,36,b--to,OTHER
5070,5071,278,2255,321,2291,be,43,36,be,OTHER
5073,5077,327,2256,403,2291,filed,76,35,filed,OTHER
5079,5082,409,2256,476,2291,with,67,35,with,OTHER
5084,5093,482,2256,658,2292,employee's,176,36,employee's,OTHER
5095,5101,665,2257,818,2293,federal,153,36,federal,OTHER
5103,5105,825,2257,879,2293,tax,54,36,tax,OTHER
5107,5112,886,2257,991,2294,return,105,37,return,OTHER
5114,5117,103,2296,162,2330,this,59,34,this,OTHER
5119,5129,167,2297,327,2330,information,160,33,information,OTHER
5131,5132,333,2298,360,2330,is,27,32,is,OTHER
5134,5138,367,2298,446,2330,being,79,32,being,OTHER
5140,5148,453,2298,586,2330,furnished,133,32,furnished,OTHER
5150,5151,592,2299,621,2330,to,29,31,to,OTHER
5153,5155,627,2299,674,2331,the,47,32,the,OTHER
5157,5164,680,2298,789,2331,internal,109,33,internal,OTHER
5166,5172,795,2298,929,2331,revenue,134,33,revenue,OTHER
5174,5181,934,2297,1046,2332,service.,112,35,service.,OTHER
