start_index,end_index,x_top_left,y_top_left,x_bottom_right,y_bottom_right,transcript,box_width,box_height,combined_text,predicted_field
39,39,504,937,527,970,a,23,33,a,OTHER
41,50,536,938,671,973,employee's,135,35,employee's,OTHER
52,57,677,941,746,973,social,69,32,social,OTHER
59,66,752,941,843,973,security,91,32,security,OTHER
68,73,849,940,936,972,number,87,32,number,OTHER
128,132,1584,940,1653,972,"safe,",69,32,"safe,",OTHER
134,142,1659,940,1803,976,accurate.,144,36,accurate.,OTHER
155,159,2092,934,2147,971,visit,55,37,visit,OTHER
161,163,2153,937,2196,973,the,43,36,the,OTHER
165,167,2202,938,2252,974,irs,50,36,irs,OTHER
169,175,2258,937,2372,974,website,114,37,website,OTHER
232,242,699,979,976,1019,481-60-4241,277,40,481-60-4241,ssnOfEmployee
321,322,1833,961,1894,1006,re,61,45,re,OTHER
324,324,1911,961,1942,1006,~,31,45,~,OTHER
326,329,1956,959,2045,1005,file,89,46,file,OTHER
432,434,1272,980,1325,1016,omb,53,36,omb,OTHER
436,438,1331,980,1370,1016,no.,39,36,no.,OTHER
440,448,1376,979,1492,1016,1545-0008,116,37,1545-0008,OTHER
459,463,1582,982,1677,1017,fast!,95,35,fast!,OTHER
465,466,1682,983,1725,1023,us,43,40,us,OTHER
485,486,2093,985,2116,1019,at,23,34,at,OTHER
488,505,2122,984,2350,1023,www.irs.gov/efile.,228,39,www.irs.gov/efile.,OTHER
507,507,116,1031,139,1066,b,23,35,b,OTHER
509,516,147,1032,248,1065,employer,101,33,employer,OTHER
518,531,254,1034,388,1065,identification,134,31,identification,OTHER
533,538,394,1033,476,1063,number,82,30,number,OTHER
540,544,483,1031,556,1062,(ein),73,31,(ein),OTHER
623,628,1448,1038,1533,1065,"wages,",85,27,"wages,",OTHER
630,634,1538,1038,1584,1065,"tips,",46,27,"tips,",OTHER
636,640,1588,1038,1645,1065,other,57,27,other,OTHER
642,653,1649,1034,1805,1064,compensation,156,30,compensation,OTHER
675,681,2002,1036,2086,1064,federal,84,28,federal,OTHER
683,688,2091,1034,2170,1064,income,79,30,income,OTHER
690,692,2175,1033,2210,1063,tax,35,30,tax,OTHER
694,701,2214,1031,2302,1061,withheld,88,30,withheld,OTHER
712,720,219,1072,447,1106,62-938578,228,34,62-938578,einEmployerIdentificationNumber
821,825,1475,1072,1603,1107,86101,128,35,86101,box1WagesTipsAndOtherCompensations
827,827,1610,1071,1628,1107,.,18,36,.,box1WagesTipsAndOtherCompensations
829,830,1634,1070,1677,1107,64,43,37,64,box1WagesTipsAndOtherCompensations
870,874,1975,1071,2105,1107,19731,130,36,19731,box2FederalIncomeTaxWithheld
876,876,2110,1071,2128,1106,.,18,35,.,box2FederalIncomeTaxWithheld
878,879,2134,1069,2176,1106,39,42,37,39,box2FederalIncomeTaxWithheld
882,882,118,1122,140,1156,c,22,34,c,OTHER
884,893,148,1123,265,1157,employer's,117,34,employer's,OTHER
895,899,271,1125,340,1157,"name,",69,32,"name,",OTHER
901,908,346,1125,439,1158,"address,",93,33,"address,",OTHER
910,912,445,1124,485,1158,and,40,34,and,OTHER
914,916,491,1123,528,1158,zip,37,35,zip,OTHER
918,921,534,1122,590,1158,code,56,36,code,OTHER
998,1003,1451,1127,1514,1159,social,63,32,social,OTHER
1005,1012,1520,1126,1602,1159,security,82,33,security,OTHER
1014,1018,1607,1124,1677,1159,wages,70,35,wages,OTHER
1049,1054,2006,1128,2071,1155,social,65,27,social,OTHER
1056,1063,2076,1125,2159,1156,security,83,31,security,OTHER
1065,1067,2163,1124,2198,1155,tax,35,31,tax,OTHER
1069,1075,2202,1122,2275,1155,withhel,73,33,withhel,OTHER
1087,1091,219,1166,344,1205,smith,125,39,smith,employerName
1093,1095,374,1166,451,1207,and,77,41,and,employerName
1097,1100,479,1166,583,1209,sons,104,43,sons,employerName
1102,1106,608,1167,735,1211,group,127,44,group,employerName
1197,1202,1479,1167,1627,1202,83019.,148,35,83019.,box3SocialSecurityWages
1204,1205,1632,1167,1680,1206,29,48,39,29,box3SocialSecurityWages
1243,1246,1984,1166,2075,1200,5350,91,34,5350,box4SocialSecurityTaxWithheld
1248,1248,2083,1168,2100,1200,.,17,32,.,box4SocialSecurityTaxWithheld
1250,1251,2106,1168,2146,1200,98,40,32,98,box4SocialSecurityTaxWithheld
1263,1266,219,1223,325,1265,7691,106,42,7691,employerAddressStreet_name
1268,1273,349,1226,506,1267,thomas,157,41,thomas,employerAddressStreet_name
1275,1278,529,1226,638,1268,fort,109,42,fort,employerAddressStreet_name
1280,1283,659,1223,770,1268,apt.,111,45,apt.,employerAddressStreet_name
1285,1287,793,1220,864,1267,726,71,47,726,employerAddressStreet_name
1369,1376,1446,1210,1547,1247,medicare,101,37,medicare,OTHER
1378,1382,1553,1212,1625,1247,wages,72,35,wages,OTHER
1384,1386,1631,1211,1671,1247,and,40,36,and,OTHER
1388,1391,1677,1210,1712,1246,tips,35,36,tips,OTHER
1420,1427,2002,1211,2102,1246,medicare,100,35,medicare,OTHER
1429,1431,2108,1212,2142,1247,tax,34,35,tax,OTHER
1433,1440,2147,1213,2233,1247,withheld,86,34,withheld,OTHER
1561,1566,1478,1250,1626,1294,77913.,148,44,77913.,OTHER
1568,1569,1632,1255,1687,1294,16,55,39,16,OTHER
1620,1623,2098,1254,2197,1293,2259,99,39,2259,OTHER
1625,1625,2204,1255,2223,1293,.,19,38,.,OTHER
1627,1628,2229,1254,2281,1292,48,52,38,48,OTHER
1639,1642,217,1284,321,1322,lake,104,38,lake,employerAddressCity
1644,1648,349,1286,465,1324,scott,116,38,scott,employerAddressCity
1677,1678,607,1285,656,1322,ok,49,37,ok,employerAddressState
1680,1689,712,1282,969,1321,92061-9387,257,39,92061-9387,employerAddressZip
1746,1751,1450,1301,1516,1335,social,66,34,social,OTHER
1753,1760,1522,1300,1602,1335,security,80,35,security,OTHER
1762,1765,1609,1299,1657,1335,tips,48,36,tips,OTHER
1797,1805,2002,1297,2103,1332,allocated,101,35,allocated,OTHER
1807,1810,2108,1297,2154,1333,tips,46,36,tips,OTHER
1932,1937,1478,1346,1627,1383,83019.,149,37,83019.,OTHER
1939,1940,1633,1345,1682,1383,29,49,38,29,OTHER
1990,1995,2103,1346,2250,1383,77913.,147,37,77913.,OTHER
1997,1998,2256,1344,2301,1383,16,45,39,16,OTHER
2001,2001,119,1392,142,1423,d,23,31,d,OTHER
2003,2009,149,1393,227,1424,control,78,31,control,OTHER
2011,2016,232,1395,320,1424,number,88,29,number,OTHER
2116,2127,1449,1394,1569,1426,verification,120,32,verification,OTHER
2129,2132,1573,1390,1634,1421,code,61,31,code,OTHER
2162,2163,1934,1395,1961,1421,10,27,26,10,OTHER
2165,2173,2005,1396,2124,1423,dependent,119,27,dependent,OTHER
2175,2178,2128,1395,2178,1423,care,50,28,care,OTHER
2180,2187,2182,1393,2264,1423,benefits,82,30,benefits,OTHER
2367,2369,2099,1439,2164,1472,184,65,33,184,OTHER
2372,2372,119,1486,139,1514,e,20,28,e,OTHER
2374,2383,149,1486,272,1514,employee's,123,28,employee's,OTHER
2385,2389,276,1486,317,1513,first,41,27,first,OTHER
2391,2394,321,1485,385,1512,name,64,27,name,OTHER
2396,2398,389,1484,430,1510,and,41,26,and,OTHER
2400,2406,434,1482,487,1509,initial,53,27,initial,OTHER
2419,2422,626,1485,674,1510,last,48,25,last,OTHER
2424,2427,678,1485,744,1510,name,66,25,name,OTHER
2474,2478,1300,1479,1360,1512,suff.,60,33,suff.,OTHER
2480,2481,1379,1478,1412,1510,11,33,32,11,OTHER
2483,2494,1449,1484,1583,1513,nonqualified,134,29,nonqualified,OTHER
2496,2500,1588,1484,1655,1512,plans,67,28,plans,OTHER
2533,2535,1934,1485,1978,1511,12a,44,26,12a,OTHER
2537,2539,2007,1485,2051,1511,see,44,26,see,OTHER
2541,2552,2055,1484,2196,1511,instructions,141,27,instructions,OTHER
2554,2556,2200,1484,2233,1511,for,33,27,for,OTHER
2558,2560,2237,1484,2285,1511,box,48,27,box,OTHER
2562,2563,2289,1484,2311,1511,12,22,27,12,OTHER
2685,2687,1478,1543,1545,1572,261,67,29,261,OTHER
2744,2747,2099,1539,2194,1575,4215,95,36,4215,OTHER
2758,2762,216,1571,360,1615,ricky,144,44,ricky,employeeName
2764,2768,422,1572,566,1617,hardy,144,45,hardy,employeeName
2911,2912,1934,1585,1963,1618,12,29,33,12,OTHER
3025,3026,1378,1591,1408,1621,13,30,30,13,OTHER
3028,3036,1414,1590,1502,1619,statutory,88,29,statutory,OTHER
3038,3047,1581,1593,1683,1621,retirement,102,28,retirement,OTHER
3057,3067,1745,1594,1842,1621,third-party,97,27,third-party,OTHER
3183,3189,1413,1618,1489,1642,employe,76,24,employe,OTHER
3193,3196,1577,1622,1624,1653,plan,47,31,plan,OTHER
3212,3215,1746,1618,1783,1642,sick,37,24,sick,OTHER
3217,3219,1785,1620,1825,1644,pay,40,24,pay,OTHER
3231,3233,223,1654,303,1695,489,80,41,489,OTHER
3235,3242,336,1654,567,1696,stephens,231,42,stephens,OTHER
3244,3248,595,1655,733,1696,coves,138,41,coves,OTHER
3390,3391,2003,1657,2049,1686,aa,46,29,aa,OTHER
3393,3395,2099,1660,2168,1691,168,69,31,168,OTHER
3406,3409,219,1718,337,1760,port,118,42,port,OTHER
3411,3414,361,1720,476,1766,dana,115,46,dana,OTHER
3449,3449,676,1717,705,1761,:,29,44,:,OTHER
3451,3460,740,1718,1029,1762,55366-3123,289,44,55366-3123,OTHER
3508,3509,1378,1705,1411,1738,14,33,33,14,OTHER
3511,3515,1448,1704,1506,1734,other,58,30,other,OTHER
3559,3560,1936,1705,1956,1737,12,20,32,12,OTHER
3562,3562,1961,1704,1975,1736,c,14,32,c,OTHER
3733,3734,2002,1771,2047,1796,bb,45,25,bb,OTHER
3743,3745,2097,1769,2168,1800,875,71,31,875,OTHER
3919,3919,2014,1876,2034,1905,h,20,29,h,OTHER
3925,3927,2098,1871,2171,1913,189,73,42,189,OTHER
3929,3929,115,1934,135,1964,1,20,30,1,OTHER
3931,3940,149,1931,273,1963,employee's,124,32,employee's,OTHER
3942,3948,278,1931,365,1960,address,87,29,address,OTHER
3950,3952,369,1931,412,1960,and,43,29,and,OTHER
3954,3956,416,1932,455,1960,zip,39,28,zip,OTHER
3958,3961,459,1933,521,1961,code,62,28,code,OTHER
3963,3964,109,1953,137,1985,15,28,32,15,OTHER
3966,3970,148,1947,212,1986,state,64,39,state,OTHER
3972,3981,260,1960,379,1992,employer's,119,32,employer's,OTHER
3983,3987,385,1960,436,1990,state,51,30,state,OTHER
3989,3990,442,1959,466,1990,id,24,31,id,OTHER
3992,3997,472,1958,561,1992,number,89,34,number,OTHER
4023,4024,756,1956,791,1994,16,35,38,16,OTHER
4026,4030,798,1957,851,1994,state,53,37,state,OTHER
4032,4037,858,1958,933,1995,"wages,",75,37,"wages,",OTHER
4039,4043,939,1959,983,1995,"tips,",44,36,"tips,",OTHER
4045,4048,989,1959,1029,1994,etc.,40,35,etc.,OTHER
4052,4053,1122,1956,1155,1994,17,33,38,17,OTHER
4055,4059,1163,1956,1215,1994,state,52,38,state,OTHER
4061,4066,1222,1956,1301,1994,income,79,38,income,OTHER
4068,4070,1306,1956,1351,1993,tax,45,37,tax,OTHER
4082,4083,1480,1954,1509,1993,18,29,39,18,OTHER
4085,4089,1515,1956,1572,1994,local,57,38,local,OTHER
4091,4096,1579,1958,1656,1995,"wages,",77,37,"wages,",OTHER
4098,4102,1663,1959,1708,1994,"tips,",45,35,"tips,",OTHER
4104,4107,1714,1959,1758,1993,etc.,44,34,etc.,OTHER
4120,4121,1864,1958,1896,1994,19,32,36,19,OTHER
4123,4127,1902,1958,1961,1993,local,59,35,local,OTHER
4129,4134,1966,1959,2046,1993,income,80,34,income,OTHER
4136,4138,2051,1961,2087,1993,tax,36,32,tax,OTHER
4150,4151,2220,1961,2252,1993,20,32,32,20,OTHER
4153,4160,2258,1961,2341,1993,locality,83,32,locality,OTHER
4162,4165,2346,1960,2415,1992,name,69,32,name,OTHER
4169,4170,127,2003,176,2039,ks,49,36,ks,OTHER
4185,4194,351,2000,604,2039,702-39-555,253,39,702-39-555,OTHER
4227,4231,756,2001,882,2040,43990,126,39,43990,box16StateWagesTips
4233,4233,888,2002,905,2041,.,17,39,.,box16StateWagesTips
4235,4236,911,2002,966,2042,05,55,40,05,box16StateWagesTips
4256,4259,1124,1997,1219,2041,3529,95,44,3529,box17StateIncomeTax
4261,4261,1226,2000,1245,2041,.,19,41,.,box17StateIncomeTax
4263,4263,1251,2001,1267,2041,8,16,40,8,box17StateIncomeTax
4286,4291,1477,1997,1625,2040,68989.,148,43,68989.,OTHER
4293,4294,1631,2001,1684,2040,01,53,39,01,OTHER
4324,4327,1865,2002,1964,2043,9279,99,41,9279,OTHER
4329,4329,1971,2005,1987,2043,.,16,38,.,OTHER
4331,4332,1994,2005,2045,2044,82,51,39,82,OTHER
4354,4359,2222,2013,2319,2042,george,97,29,george,OTHER
4361,4367,2334,2012,2444,2041,station,110,29,station,OTHER
4372,4373,134,2092,178,2124,il,44,32,il,OTHER
4392,4401,350,2088,609,2127,324-96-295,259,39,324-96-295,OTHER
4430,4434,757,2089,882,2129,39192,125,40,39192,OTHER
4436,4436,888,2089,904,2128,.,16,39,.,OTHER
4438,4439,910,2089,952,2128,58,42,39,58,OTHER
4459,4464,1119,2088,1275,2130,2963.5,156,42,2963.5,OTHER
4488,4492,1477,2088,1601,2131,96741,124,43,96741,OTHER
4494,4494,1608,2088,1626,2128,.,18,40,.,OTHER
4496,4497,1633,2087,1688,2128,06,55,41,06,OTHER
4527,4531,1867,2088,1992,2129,11499,125,41,11499,OTHER
4533,4533,2000,2088,2017,2128,.,17,40,.,OTHER
4535,4536,2024,2088,2071,2129,77,47,41,77,OTHER
4557,4565,2221,2098,2362,2131,stephanie,141,33,stephanie,OTHER
4567,4571,2370,2099,2451,2136,cliff,81,37,cliff,OTHER
4596,4599,360,2147,479,2190,wage,119,43,wage,OTHER
4601,4603,489,2147,571,2190,and,82,43,and,OTHER
4605,4607,581,2147,650,2190,tax,69,43,tax,OTHER
4662,4665,1137,2150,1405,2242,2018,268,92,2018,taxYear
4717,4726,1755,2156,1904,2192,department,149,36,department,OTHER
4728,4729,1910,2158,1935,2192,of,25,34,of,OTHER
4731,4733,1941,2158,1986,2192,the,45,34,the,OTHER
4735,4752,1991,2158,2220,2192,treasury--internal,229,34,treasury--internal,OTHER
4754,4760,2225,2158,2346,2192,revenue,121,34,revenue,OTHER
4762,4768,2350,2157,2453,2192,service,103,35,service,OTHER
4770,4773,104,2212,166,2250,form,62,38,form,OTHER
4775,4777,182,2214,240,2250,w-2,58,36,w-2,OTHER
4788,4796,361,2202,575,2249,statement,214,47,statement,OTHER
4799,4802,108,2254,180,2291,copy,72,37,copy,OTHER
4804,4808,187,2255,273,2291,b--to,86,36,b--to,OTHER
4810,4811,280,2255,320,2291,be,40,36,be,OTHER
4813,4817,326,2255,403,2291,filed,77,36,filed,OTHER
4819,4822,410,2256,474,2291,with,64,35,with,OTHER
4824,4833,481,2256,658,2292,employee's,177,36,employee's,OTHER
4835,4841,664,2257,817,2293,federal,153,36,federal,OTHER
4843,4845,824,2257,878,2293,tax,54,36,tax,OTHER
4847,4852,885,2257,991,2294,return,106,37,return,OTHER
4854,4857,103,2296,161,2330,this,58,34,this,OTHER
4859,4869,167,2297,329,2330,information,162,33,information,OTHER
4871,4872,335,2298,359,2330,is,24,32,is,OTHER
4874,4878,366,2298,447,2330,being,81,32,being,OTHER
4880,4888,454,2298,586,2330,furnished,132,32,furnished,OTHER
4890,4891,593,2298,622,2330,to,29,32,to,OTHER
4893,4895,628,2298,674,2330,the,46,32,the,OTHER
4897,4904,681,2298,789,2331,internal,108,33,internal,OTHER
4906,4912,795,2298,926,2331,revenue,131,33,revenue,OTHER
4914,4921,931,2297,1045,2331,service.,114,34,service.,OTHER
