start_index,end_index,x_top_left,y_top_left,x_bottom_right,y_bottom_right,transcript,box_width,box_height,combined_text,predicted_field
0,0,826,170,931,208,earnings,105,38,earnings,OTHER
0,0,722,184,767,217,this,45,33,this,OTHER
0,0,1212,415,1243,442,w.2,31,27,w.2,OTHER
0,0,1001,556,1043,587,was,42,31,was,OTHER
0,0,1016,851,1091,883,profile.,75,32,profile.,OTHER
0,0,176,1477,221,1501,236428,45,24,236428,OTHER
0,0,502,1503,569,1535,withheld,67,32,withheld,OTHER
0,0,421,1887,447,1915,12a,26,28,12a,OTHER
0,0,370,2183,395,2210,state,25,27,state,OTHER
0,0,488,2275,538,2305,locality,50,30,locality,OTHER
0,0,389,2389,476,2416,statement,87,27,statement,OTHER
245,247,1764,39,1825,79,adp,61,40,adp,OTHER
358,361,787,123,896,176,2018,109,53,2018,OTHER
363,365,902,115,997,169,w-2,95,54,w-2,OTHER
367,369,1006,106,1095,161,and,89,55,and,OTHER
371,378,1103,84,1356,153,earnings,253,69,earnings,OTHER
380,386,1366,60,1620,131,summary,254,71,summary,OTHER
488,488,871,729,886,754,t,15,25,t,OTHER
490,491,1137,151,1158,180,is,21,29,is,OTHER
493,496,771,179,823,213,blue,52,34,blue,OTHER
499,499,321,752,339,778,a,18,26,a,OTHER
502,503,1710,101,1732,131,in,22,30,in,OTHER
507,513,935,160,1046,198,summary,111,38,summary,OTHER
515,521,1050,153,1133,188,section,83,35,section,OTHER
526,533,1162,142,1260,178,included,98,36,included,OTHER
535,538,1265,137,1314,169,with,49,32,with,OTHER
540,543,1319,133,1368,164,your,49,31,your,OTHER
545,547,1373,128,1422,160,w-2,49,32,w-2,OTHER
549,550,1427,126,1451,155,to,24,29,to,OTHER
552,555,1456,121,1508,152,help,52,31,help,OTHER
557,564,1513,112,1607,147,describe,94,35,describe,OTHER
566,573,1612,104,1705,139,portions,93,35,portions,OTHER
578,581,1737,96,1799,128,more,62,32,more,OTHER
583,589,1805,90,1867,123,detail.,62,33,detail.,OTHER
642,645,427,215,473,239,copy,46,24,copy,OTHER
691,693,721,212,765,243,the,44,31,the,OTHER
695,701,768,206,857,239,reverse,89,33,reverse,OTHER
703,706,860,202,909,231,side,49,29,side,OTHER
708,715,912,193,1011,226,includes,99,33,includes,OTHER
717,723,1014,186,1101,218,general,87,32,general,OTHER
725,735,1104,174,1233,210,information,129,36,information,OTHER
737,740,1237,170,1282,198,that,45,28,that,OTHER
742,744,1285,165,1328,194,you,43,29,you,OTHER
746,748,1332,160,1386,189,may,54,29,may,OTHER
750,753,1389,155,1437,184,also,48,29,also,OTHER
755,758,1441,150,1484,179,find,43,29,find,OTHER
760,767,1488,142,1566,175,helpful.,78,33,helpful.,OTHER
782,789,118,236,212,266,employee,94,30,employee,OTHER
828,830,295,256,326,277,and,31,21,and,OTHER
832,834,359,248,386,271,tax,27,23,tax,OTHER
968,969,1457,263,1472,286,nv,15,23,nv,OTHER
971,971,1475,262,1478,285,.,3,23,.,OTHER
973,977,1481,260,1512,285,state,31,25,state,OTHER
979,984,1516,256,1565,282,income,49,26,income,OTHER
986,988,1569,253,1593,278,tax,24,25,tax,OTHER
992,998,1649,245,1695,266,5328.48,46,21,5328.48,OTHER
1027,1035,212,280,285,310,statement,73,30,statement,OTHER
1051,1054,1253,241,1303,272,2018,50,31,2018,OTHER
1106,1107,790,284,813,311,1.,23,27,1.,OTHER
1109,1111,817,280,854,309,the,37,29,the,OTHER
1113,1121,858,272,948,305,following,90,33,following,OTHER
1123,1133,952,261,1069,297,information,117,36,information,OTHER
1135,1142,1073,254,1150,287,reflects,77,33,reflects,OTHER
1146,1149,1758,198,1805,228,your,47,30,your,OTHER
1161,1168,1298,274,1356,295,14194.83,58,21,14194.83,OTHER
1324,1328,1205,246,1249,276,final,44,30,final,OTHER
1330,1333,423,271,497,306,2018,74,35,2018,taxYear
1336,1338,1307,237,1346,267,pay,39,30,pay,OTHER
1340,1343,1350,233,1396,263,stub,46,30,stub,OTHER
1345,1348,1400,229,1445,259,plus,45,30,plus,OTHER
1349,1351,1460,284,1485,304,box,25,20,box,OTHER
1352,1354,1449,225,1486,255,any,37,30,any,OTHER
1540,1541,1489,285,1503,303,17,14,18,17,OTHER
1543,1544,1507,285,1519,303,of,12,18,of,OTHER
1545,1555,1491,214,1618,251,adjustments,127,37,adjustments,OTHER
1748,1750,1522,283,1553,303,w-2,31,20,w-2,OTHER
1759,1766,1652,280,1708,305,38116.94,56,25,38116.94,OTHER
1768,1769,1727,202,1754,231,by,27,29,by,OTHER
1771,1774,1154,250,1201,280,your,47,30,your,OTHER
1776,1784,1810,189,1917,224,employer.,107,35,employer.,OTHER
1987,1995,1623,205,1722,240,submitted,99,35,submitted,OTHER
1999,2001,40,302,104,337,w-2,64,35,w-2,OTHER
2047,2049,412,310,439,337,omb,27,27,omb,OTHER
2051,2053,444,308,465,334,no.,21,26,no.,OTHER
2055,2063,469,302,538,332,1545-0008,69,30,1545-0008,OTHER
2125,2132,989,298,1045,326,314831.3,56,28,314831.3,OTHER
2138,2143,1147,298,1188,318,social,41,20,social,OTHER
2145,2152,1191,292,1237,317,security,46,25,security,OTHER
2176,2180,1461,301,1496,322,local,35,21,local,OTHER
2182,2187,1499,296,1548,321,income,49,25,income,OTHER
2189,2191,1552,292,1573,316,tax,21,24,tax,OTHER
2247,2254,461,331,516,356,employer,55,25,employer,OTHER
2256,2258,520,329,541,353,use,21,24,use,OTHER
2260,2263,545,325,577,351,only,32,26,only,OTHER
2306,2310,856,316,893,342,gross,37,26,gross,OTHER
2312,2314,895,313,922,337,pay,27,24,pay,OTHER
2335,2337,1149,326,1174,347,box,25,21,box,OTHER
2339,2339,1178,325,1185,347,4,7,22,4,OTHER
2341,2342,1189,325,1200,346,of,11,21,of,OTHER
2344,2346,1204,320,1236,345,w-2,32,25,w-2,OTHER
2370,2372,1462,324,1489,349,box,27,25,box,OTHER
2374,2375,1492,322,1507,346,19,15,24,19,OTHER
2377,2378,1510,320,1521,344,of,11,24,of,OTHER
2380,2382,1525,314,1559,342,w-2,34,28,w-2,OTHER
2408,2412,206,352,254,381,dept.,48,29,dept.,OTHER
2414,2418,287,348,327,380,corp.,40,32,corp.,OTHER
2420,2423,33,352,64,375,copy,31,23,copy,OTHER
2425,2425,68,351,75,374,c,7,23,c,OTHER
2427,2429,78,351,95,374,for,17,23,for,OTHER
2431,2440,99,347,163,373,employee's,64,26,employee's,OTHER
2442,2449,167,342,226,369,records.,59,27,records.,OTHER
2585,2591,1328,355,1373,380,6484.09,45,25,6484.09,OTHER
2594,2594,35,373,51,396,d,16,23,d,OTHER
2596,2602,62,366,109,394,control,47,28,control,OTHER
2604,2609,112,357,173,389,number,61,32,number,OTHER
2734,2741,1152,372,1213,402,medicare,61,30,medicare,OTHER
2743,2744,1216,370,1234,396,ta,18,26,ta,OTHER
2772,2775,1470,375,1492,398,sui/,22,23,sui/,OTHER
2777,2783,1496,373,1543,396,sdi/fli,47,23,sdi/fli,OTHER
2785,2791,37,383,100,413,1954335,63,30,1954335,OTHER
2798,2807,68,415,139,447,employer's,71,32,employer's,OTHER
2809,2812,143,412,176,441,name,33,29,name,OTHER
2814,2814,179,412,183,438,",",4,26,",",OTHER
2816,2822,186,408,233,438,address,47,30,address,OTHER
2824,2824,236,407,240,433,",",4,26,",",OTHER
2826,2828,243,404,267,432,and,24,28,and,OTHER
2830,2832,271,402,291,429,zip,20,27,zip,OTHER
2834,2837,295,398,329,427,code,34,29,code,OTHER
2906,2909,862,402,892,429,fed.,30,27,fed.,OTHER
2911,2916,895,398,945,424,income,50,26,income,OTHER
2918,2925,990,388,1052,414,64208.31,62,26,64208.31,OTHER
2937,2939,1470,392,1495,416,box,25,24,box,OTHER
2941,2941,1185,420,1192,444,6,7,24,6,OTHER
2943,2944,1516,392,1528,416,of,12,24,of,OTHER
2946,2947,1531,391,1546,415,w.,15,24,w.,OTHER
2948,2948,1548,391,1562,415,2,14,24,2,OTHER
3130,3132,1161,420,1181,446,box,20,26,box,OTHER
3134,3135,1498,392,1513,416,14,15,24,14,OTHER
3137,3138,1196,418,1208,443,of,12,25,of,OTHER
3140,3140,1680,603,1693,631,w,13,28,w,OTHER
3141,3141,1348,627,1350,654,.,2,27,.,OTHER
3143,3143,896,443,904,467,2,8,24,2,OTHER
3152,3156,85,438,146,467,dixon,61,29,dixon,OTHER
3158,3160,153,436,191,463,llc,38,27,llc,employerName
3162,3166,197,434,257,460,group,60,26,group,OTHER
3259,3261,867,429,890,453,tax,23,24,tax,OTHER
3264,3271,893,420,954,448,withheld,61,28,withheld,OTHER
3388,3390,869,445,892,472,box,23,27,box,OTHER
3392,3392,1353,627,1355,654,2,2,27,2,OTHER
3394,3395,909,442,919,465,of,10,23,of,OTHER
3397,3399,923,438,958,464,w-2,35,26,w-2,OTHER
3409,3411,90,461,127,487,773,37,26,773,OTHER
3413,3418,131,458,205,487,miller,74,29,miller,OTHER
3420,3424,210,454,271,485,wells,61,31,wells,OTHER
3426,3430,277,449,337,481,suite,60,32,suite,OTHER
3431,3440,356,462,470,497,44169-8232,114,35,44169-8232,OTHER
3447,3449,343,445,381,475,955,38,30,955,OTHER
3460,3463,90,490,141,517,west,51,27,west,OTHER
3465,3477,149,478,296,514,jonathanshire,147,36,jonathanshire,OTHER
3479,3479,312,474,324,501,c,12,27,c,OTHER
3520,3524,304,554,364,579,batch,60,25,batch,OTHER
3541,3546,452,539,527,567,#02021,75,28,#02021,OTHER
3660,3661,814,574,836,602,2.,22,28,2.,OTHER
3663,3666,839,569,891,600,your,52,31,your,OTHER
3668,3672,894,564,955,596,gross,61,32,gross,OTHER
3674,3676,958,560,997,590,pay,39,30,pay,OTHER
3679,3680,1140,546,1166,575,as,26,29,as,OTHER
3682,3689,1047,549,1136,583,adjusted,89,34,adjusted,OTHER
3691,3691,1638,802,1651,829,a,13,27,a,OTHER
3694,3700,1170,540,1241,572,follows,71,32,follows,OTHER
3702,3703,1245,537,1267,565,to,22,28,to,OTHER
3704,3709,1278,586,1318,614,social,40,28,social,OTHER
3870,3876,1272,529,1356,563,produce,84,34,produce,OTHER
3899,3906,1486,567,1540,594,nv.state,54,27,nv.state,OTHER
3907,3910,1521,579,1556,614,etc.,35,35,etc.,OTHER
3911,3916,1543,561,1602,591,"wages,",59,30,"wages,",OTHER
3918,3923,1612,557,1661,586,hansen,49,29,hansen,OTHER
4099,4102,1361,525,1408,555,your,47,30,your,OTHER
4104,4106,1413,521,1456,551,w-2,43,30,w-2,OTHER
4108,4117,1461,510,1571,546,statement.,110,36,statement.,OTHER
4307,4311,1486,581,1517,616,"tips,",31,35,"tips,",OTHER
4327,4331,1613,578,1650,609,local,37,31,local,OTHER
4333,4337,1664,555,1689,580,cliff,25,25,cliff,OTHER
4554,4558,1652,578,1697,604,wages,45,26,wages,OTHER
4724,4727,1323,583,1353,610,secu,30,27,secu,OTHER
4730,4737,1357,579,1411,607,medicare,54,28,medicare,OTHER
4905,4909,1358,601,1413,627,wages,55,26,wages,OTHER
4914,4916,57,614,83,641,elf,26,27,elf,OTHER
4918,4926,87,609,155,639,employees,68,30,employees,OTHER
4928,4932,160,605,200,634,"name,",40,29,"name,",OTHER
4934,4940,205,601,254,630,address,49,29,address,OTHER
4942,4944,259,599,281,626,and,22,27,and,OTHER
4946,4948,286,597,306,623,zip,20,26,zip,OTHER
4950,4953,311,593,348,621,code,37,28,code,OTHER
5049,5054,1074,605,1123,633,"wages,",49,28,"wages,",OTHER
5056,5060,1126,602,1157,628,"tips,",31,26,"tips,",OTHER
5062,5066,1160,600,1191,625,other,31,25,other,OTHER
5099,5101,1489,611,1514,639,box,25,28,box,OTHER
5103,5104,1518,610,1531,635,16,13,25,16,OTHER
5106,5107,1535,609,1546,634,of,11,25,of,OTHER
5109,5111,1550,608,1585,634,w-2,35,26,w-2,OTHER
5113,5116,1615,608,1644,638,tipx,29,30,tipx,OTHER
5118,5119,1647,617,1663,639,18,16,22,18,OTHER
5121,5122,1666,611,1676,637,of,10,26,of,OTHER
5124,5124,1335,628,1344,655,w,9,27,w,OTHER
5263,5274,1076,626,1173,655,compensation,97,29,compensation,OTHER
5413,5415,1361,624,1386,653,box,25,29,box,OTHER
5417,5417,1108,649,1114,673,1,6,24,1,OTHER
5419,5420,1320,629,1330,656,of,10,27,of,OTHER
5422,5422,1416,621,1426,648,w,10,27,w,OTHER
5424,5424,1147,646,1148,669,-,1,23,-,OTHER
5426,5426,1434,619,1453,646,2,19,27,2,OTHER
5433,5435,1077,649,1104,673,box,27,24,box,OTHER
5437,5437,1309,630,1316,657,3,7,27,3,OTHER
5439,5440,1402,622,1412,649,of,10,27,of,OTHER
5442,5442,1134,646,1143,671,w,9,25,w,OTHER
5444,5444,1429,620,1432,647,.,3,27,.,OTHER
5446,5446,1152,644,1165,669,2,13,25,2,OTHER
5449,5451,1280,631,1305,660,box,25,29,box,OTHER
5453,5453,1391,623,1397,650,5,6,27,5,OTHER
5455,5456,1119,648,1130,672,of,11,24,of,OTHER
5458,5458,242,703,258,730,w,16,27,w,OTHER
5460,5460,258,809,269,835,.,11,26,.,OTHER
5462,5462,1679,1326,1701,1357,2,22,31,2,OTHER
5474,5480,102,657,189,686,michael,87,29,michael,OTHER
5482,5488,205,651,280,682,spencer,75,31,spencer,OTHER
5654,5661,1498,663,1557,696,314831.3,59,33,314831.3,OTHER
5674,5680,1627,653,1677,678,314831.,50,25,314831.,OTHER
5691,5695,109,685,170,714,14193,61,29,14193,OTHER
5697,5703,173,678,258,709,richard,85,31,richard,OTHER
5705,5708,262,675,311,704,camp,49,29,camp,OTHER
5841,5846,1285,690,1330,713,314831,45,23,314831,OTHER
5848,5851,1622,677,1658,698,7905,36,21,7905,OTHER
5854,5861,1371,673,1426,706,314831.3,55,33,314831.3,OTHER
5892,5895,1366,696,1405,723,7905,39,27,7905,OTHER
5934,5938,297,693,347,723,38332,50,30,38332,OTHER
5940,5940,352,693,359,718,-,7,25,-,OTHER
5942,5945,364,690,408,717,8400,44,27,8400,OTHER
6037,6040,1084,706,1114,740,7905,30,34,7905,OTHER
6042,6050,1115,697,1179,727,314831.33,64,30,314831.33,OTHER
6087,6089,1497,700,1525,722,584,28,22,584,OTHER
6103,6106,114,715,161,742,port,47,27,port,OTHER
6108,6112,166,708,225,739,terry,59,31,terry,OTHER
6213,6217,894,725,926,749,gross,32,24,gross,OTHER
6219,6221,930,724,963,746,pay,33,22,pay,OTHER
6231,6234,1085,747,1146,772,5841,61,25,5841,OTHER
6250,6251,1287,722,1320,750,,33,28,,OTHER
6253,6259,1369,721,1419,751,64208.3,50,30,64208.3,OTHER
6281,6288,1498,713,1554,739,64208.31,56,26,64208.31,OTHER
6301,6307,1627,720,1671,746,236428.,44,26,236428.,OTHER
6309,6310,1676,720,1686,745,19,10,25,19,OTHER
6352,6352,407,1734,427,1762,a,20,28,a,OTHER
6354,6363,349,743,422,775,employee's,73,32,employee's,OTHER
6365,6375,451,752,540,783,313-40-8657,89,31,313-40-8657,ssnOfEmployee
6434,6436,426,741,451,768,ssa,25,27,ssa,OTHER
6438,6443,455,737,518,766,number,63,29,number,OTHER
6495,6500,863,750,898,774,401(k),35,24,401(k),OTHER
6502,6507,902,745,945,770,(d-box,43,25,(d-box,OTHER
6509,6510,948,743,968,765,2),20,22,2),OTHER
6543,6545,1332,748,1363,778,.19,31,30,.19,OTHER
6547,6553,1373,742,1416,775,236428.,43,33,236428.,OTHER
6555,6556,1420,739,1434,768,19,14,29,19,OTHER
6567,6575,1498,730,1558,762,236428.19,60,32,236428.19,OTHER
6582,6582,69,775,84,799,b,15,24,b,OTHER
6584,6593,102,768,171,796,employer's,69,28,employer's,OTHER
6595,6597,175,765,200,790,fed,25,25,fed,OTHER
6599,6600,204,764,218,788,id,14,24,id,OTHER
6602,6607,222,758,281,786,number,59,28,number,OTHER
6691,6694,831,773,861,795,less,30,22,less,OTHER
6696,6700,864,771,901,793,other,37,22,other,OTHER
6702,6705,904,768,934,790,cafe,30,22,cafe,OTHER
6707,6709,938,766,964,787,125,26,21,125,OTHER
6718,6726,1089,767,1149,799,236428.19,60,32,236428.19,OTHER
6770,6776,352,798,401,827,federal,49,29,federal,OTHER
6778,6783,405,794,452,823,income,47,29,income,OTHER
6784,6791,454,804,525,833,64208.31,71,29,64208.31,OTHER
6851,6853,457,792,475,819,tax,18,27,tax,OTHER
6855,6862,480,784,539,816,withheld,59,32,withheld,OTHER
6908,6915,835,792,893,814,reported,58,22,reported,OTHER
6917,6919,895,789,920,810,w-2,25,21,w-2,OTHER
6921,6925,923,784,974,808,wages,51,24,wages,OTHER
6936,6940,104,821,144,847,wages,40,26,wages,OTHER
6942,6942,149,821,152,844,",",3,23,",",OTHER
6944,6948,157,818,183,844,"tips,",26,26,"tips,",OTHER
6949,6951,168,830,203,860,.19,35,30,.19,OTHER
6963,6968,121,836,166,864,236428,45,28,236428,OTHER
6977,6981,187,815,220,842,other,33,27,other,OTHER
6983,6986,223,811,255,838,comp,32,27,comp,OTHER
6988,6988,590,1788,593,1811,.,3,23,.,OTHER
7049,7051,453,844,474,868,tax,21,24,tax,OTHER
7053,7056,1746,790,1789,820,with,43,30,with,OTHER
7060,7060,1437,1473,1452,1495,d,15,22,d,OTHER
7068,7068,80,875,96,900,3,16,25,3,OTHER
7070,7075,111,873,150,898,social,39,25,social,OTHER
7079,7086,154,869,203,895,security,49,26,security,OTHER
7088,7092,206,866,254,891,wages,48,25,wages,OTHER
7121,7128,459,860,528,887,14194.83,69,27,14194.83,OTHER
7178,7179,842,870,863,898,3.,21,28,3.,OTHER
7181,7188,1255,828,1356,862,employee,101,34,employee,OTHER
7190,7192,1702,794,1741,824,w-4,39,30,w-4,OTHER
7194,7200,1406,818,1471,849,profile,65,31,profile,OTHER
7201,7201,512,1987,513,2018,.,1,31,.,OTHER
7203,7204,1094,848,1121,876,to,27,28,to,OTHER
7206,7211,1124,841,1200,873,change,76,32,change,OTHER
7213,7216,1794,786,1840,816,your,46,30,your,OTHER
7218,7225,865,861,967,896,employee,102,35,employee,OTHER
7227,7229,1360,824,1402,853,w-4,42,29,w-4,OTHER
7234,7237,1602,804,1633,832,file,31,28,file,OTHER
7239,7250,1475,807,1598,843,"information,",123,36,"information,",OTHER
7252,7259,1554,865,1598,890,security,44,25,security,OTHER
7273,7279,1701,860,1765,889,married,64,29,married,OTHER
7480,7485,1601,863,1647,886,number,46,23,number,OTHER
7488,7490,1656,798,1697,827,new,41,29,new,OTHER
7492,7494,970,857,1013,887,w-4,43,30,w-4,OTHER
7496,7499,1614,2328,1639,2355,with,25,27,with,OTHER
7501,7504,1204,837,1252,866,your,48,29,your,OTHER
7506,7512,1845,779,1916,812,payroll,71,33,payroll,OTHER
7514,7518,1921,774,1971,806,dept.,50,32,dept.,OTHER
7533,7541,126,888,204,914,185553.33,78,26,185553.33,OTHER
7702,7708,1512,888,1556,912,taxable,44,24,taxable,OTHER
7710,7716,1559,887,1601,909,marital,42,22,marital,OTHER
7718,7724,1603,887,1655,909,stances,52,22,stances,OTHER
7771,7778,360,907,420,939,medicare,60,32,medicare,OTHER
7780,7782,424,905,444,932,tax,20,27,tax,OTHER
7784,7791,477,837,542,866,withheld,65,29,withheld,OTHER
7852,7858,466,923,522,949,6484.09,56,26,6484.09,OTHER
7976,7997,1516,897,1659,935,exemptions/allowances:,143,38,exemptions/allowances:,OTHER
8006,8006,84,935,100,960,5,16,25,5,OTHER
8008,8015,114,931,174,958,medicare,60,27,medicare,OTHER
8020,8024,178,928,220,952,wages,42,24,wages,OTHER
8026,8028,224,926,247,949,and,23,23,and,OTHER
8030,8033,251,923,281,947,tips,30,24,tips,OTHER
8048,8056,130,944,211,971,223589.25,81,27,223589.25,OTHER
8158,8164,911,937,1013,971,michael,102,34,michael,OTHER
8166,8172,1031,928,1126,962,spencer,95,34,spencer,OTHER
8218,8222,1518,927,1564,952,state,46,25,state,OTHER
8270,8278,368,962,426,995,allocated,58,33,allocated,OTHER
8280,8288,469,970,539,1003,223589.25,70,33,223589.25,OTHER
8350,8353,431,960,466,990,tips,35,30,tips,OTHER
8474,8478,1517,946,1568,971,local,51,25,local,OTHER
8493,8498,123,989,161,1013,social,38,24,social,OTHER
8500,8507,164,985,213,1012,security,49,27,security,OTHER
8509,8512,217,981,239,1007,tips,22,26,tips,OTHER
8604,8608,921,975,987,1004,14193,66,29,14193,OTHER
8610,8616,994,966,1092,999,richard,98,33,richard,OTHER
8618,8621,1098,959,1156,990,camp,58,31,camp,OTHER
8637,8645,135,1000,217,1031,185553.33,82,31,185553.33,OTHER
8771,8772,1179,990,1208,1016,ct,29,26,ct,OTHER
8818,8819,345,1019,369,1046,10,24,27,10,OTHER
8821,8829,374,1013,444,1046,dependent,70,33,dependent,OTHER
8831,8834,448,1009,474,1041,care,26,32,care,OTHER
8836,8843,479,1001,540,1037,benefits,61,36,benefits,OTHER
8898,8901,919,1010,979,1042,west,60,32,west,OTHER
8903,8915,987,996,1159,1034,jonathanshire,172,38,jonathanshire,OTHER
8929,8940,124,1036,198,1067,verification,74,31,verification,OTHER
8942,8945,202,1033,238,1060,code,36,27,code,OTHER
8990,8992,351,1072,377,1098,12a,26,26,12a,OTHER
8994,8996,381,1070,403,1097,see,22,27,see,OTHER
8998,9009,407,1064,481,1096,instructions,74,32,instructions,OTHER
9011,9013,484,1061,502,1090,for,18,29,for,OTHER
9015,9017,505,1058,531,1088,box,26,30,box,OTHER
9019,9020,534,1055,558,1084,12,24,29,12,OTHER
9032,9033,100,1094,121,1117,11,21,23,11,OTHER
9035,9046,131,1088,214,1115,nonqualified,83,27,nonqualified,OTHER
9048,9052,218,1084,257,1110,plans,39,26,plans,OTHER
9109,9109,470,1109,477,1133,1,7,24,1,OTHER
9111,9114,481,1105,523,1132,7905,42,27,7905,OTHER
9162,9164,353,1131,388,1161,126,35,30,126,OTHER
9165,9165,471,1138,479,1166,1,8,28,1,OTHER
9167,9169,484,1136,519,1165,740,35,29,740,OTHER
9180,9181,103,1150,125,1174,14,22,24,14,OTHER
9183,9187,141,1144,184,1169,other,43,25,other,OTHER
9217,9219,359,1158,391,1187,120,32,29,120,OTHER
9220,9221,402,1167,418,1194,mo,16,27,mo,OTHER
9223,9225,423,1166,439,1193,ret,16,27,ret,OTHER
9227,9230,444,1165,478,1192,plan,34,27,plan,OTHER
9232,9234,488,1164,500,1191,ard,12,27,ard,OTHER
9236,9240,505,1163,530,1190,party,25,27,party,OTHER
9242,9245,535,1162,551,1190,sick,16,28,sick,OTHER
9247,9249,556,1161,586,1189,pay,30,28,pay,OTHER
9262,9263,112,1241,134,1266,15,22,25,15,OTHER
9265,9269,398,1211,429,1240,state,31,29,state,OTHER
9271,9280,219,1225,280,1257,employers',61,32,employers',OTHER
9283,9287,284,1221,311,1249,state,27,28,state,OTHER
9289,9290,315,1220,325,1246,id,10,26,id,OTHER
9292,9294,329,1216,359,1245,no.,30,29,no.,OTHER
9296,9297,364,1214,386,1242,16,22,28,16,OTHER
9299,9303,146,1241,186,1266,state,40,25,state,OTHER
9305,9310,434,1208,478,1237,"wages,",44,29,"wages,",OTHER
9312,9316,482,1206,509,1235,"tips,",27,29,"tips,",OTHER
9318,9321,513,1205,547,1234,etc.,34,29,etc.,OTHER
9345,9354,220,1242,310,1274,345-04-585,90,32,345-04-585,OTHER
9398,9399,368,1268,391,1295,18,23,27,18,OTHER
9401,9405,400,1266,435,1293,local,35,27,local,OTHER
9407,9412,440,1264,482,1292,"wages,",42,28,"wages,",OTHER
9414,9418,487,1263,514,1289,"tips,",27,26,"tips,",OTHER
9420,9423,518,1262,553,1288,etc.,35,26,etc.,OTHER
9437,9441,155,1289,185,1313,state,30,24,state,OTHER
9444,9449,189,1283,238,1311,income,49,28,income,OTHER
9451,9453,241,1278,269,1305,tax,28,27,tax,OTHER
9469,9475,161,1301,227,1333,5328.48,66,32,5328.48,OTHER
9576,9579,891,1294,920,1318,2018,29,24,2018,OTHER
9581,9584,923,1292,954,1316,"adp,",31,24,"adp,",OTHER
9586,9588,958,1288,987,1313,llc,29,25,llc,OTHER
9633,9634,372,1319,395,1345,20,23,26,20,OTHER
9636,9643,405,1318,455,1345,locality,50,27,locality,OTHER
9645,9648,460,1317,505,1344,name,45,27,name,OTHER
9651,9656,499,1326,551,1353,hansen,52,27,hansen,OTHER
9658,9662,555,1321,603,1351,cliff,48,30,cliff,OTHER
9815,9815,381,1442,400,1469,2,19,27,2,OTHER
9817,9823,1706,1322,1753,1354,federal,47,32,federal,OTHER
9825,9830,1759,1317,1804,1348,income,45,31,income,OTHER
9832,9839,1810,1337,1881,1364,64208.31,71,27,64208.31,OTHER
10086,10088,1810,1315,1828,1342,tax,18,27,tax,OTHER
10090,10097,448,902,505,930,withheld,57,28,withheld,OTHER
10110,10111,119,1343,142,1366,19,23,23,19,OTHER
10113,10117,158,1339,192,1365,local,34,26,local,OTHER
10119,10124,196,1334,245,1362,income,49,28,income,OTHER
10126,10128,248,1330,276,1356,tax,28,26,tax,OTHER
10294,10299,1455,1348,1501,1378,"wages,",46,30,"wages,",OTHER
10301,10305,1505,1345,1532,1373,"tips,",27,28,"tips,",OTHER
10307,10311,1537,1340,1568,1370,other,31,30,other,OTHER
10313,10317,1573,1334,1615,1365,comp.,42,31,comp.,OTHER
10328,10333,1712,1361,1748,1392,social,36,31,social,OTHER
10335,10342,1752,1359,1800,1390,security,48,31,security,OTHER
10344,10346,1804,1359,1826,1388,tax,22,29,tax,OTHER
10348,10355,1833,1308,1896,1340,withheld,63,32,withheld,OTHER
10500,10506,1040,1380,1088,1411,federal,48,31,federal,OTHER
10508,10513,1094,1375,1140,1406,income,46,31,income,OTHER
10515,10517,1145,1373,1165,1400,tax,20,27,tax,OTHER
10519,10526,1829,1357,1890,1386,withheld,61,29,withheld,OTHER
10551,10551,1429,1389,1444,1413,3,15,24,3,OTHER
10553,10558,1461,1384,1499,1411,social,38,27,social,OTHER
10561,10565,1504,1383,1538,1408,secur,34,25,secur,OTHER
10768,10776,1494,1391,1574,1419,185553.33,80,28,185553.33,OTHER
10891,10894,812,1403,836,1426,"ges,",24,23,"ges,",OTHER
10896,10900,840,1401,867,1425,"tips,",27,24,"tips,",OTHER
10902,10906,871,1397,905,1423,other,34,26,other,OTHER
10908,10912,909,1392,949,1420,comp.,40,28,comp.,OTHER
10920,10925,1045,1417,1082,1452,social,37,35,social,OTHER
10927,10934,1088,1416,1135,1449,security,47,33,security,OTHER
10936,10938,1775,1397,1795,1425,tax,20,28,tax,OTHER
10940,10947,1170,1366,1229,1398,withheld,59,32,withheld,OTHER
10981,10989,1494,1409,1570,1429,185595-85,76,20,185595-85,OTHER
11008,11015,1712,1399,1770,1432,medicare,58,33,medicare,OTHER
11017,11019,1141,1416,1160,1446,tax,19,30,tax,OTHER
11021,11027,1817,1412,1882,1440,6484.09,65,28,6484.09,OTHER
11276,11283,1800,1393,1866,1423,withheld,66,30,withheld,OTHER
11397,11402,825,1422,871,1444,236428,46,22,236428,OTHER
11404,11406,874,1419,903,1442,.19,29,23,.19,OTHER
11479,11479,1430,1427,1446,1450,5,16,23,5,OTHER
11481,11488,1461,1422,1521,1447,medicare,60,25,medicare,OTHER
11490,11494,1525,1419,1567,1442,wages,42,23,wages,OTHER
11496,11498,1570,1417,1596,1439,and,26,22,and,OTHER
11500,11503,1598,1415,1628,1439,tips,30,24,tips,OTHER
11537,11544,1864,1431,1918,1460,employer,54,29,employer,OTHER
11546,11548,1923,1431,1944,1458,use,21,27,use,OTHER
11550,11553,1948,1430,1987,1458,only,39,28,only,OTHER
11600,11600,1543,2336,1552,2360,2,9,24,2,OTHER
11602,11608,408,1437,455,1467,federal,47,30,federal,OTHER
11610,11615,460,1432,506,1462,income,46,30,income,OTHER
11617,11624,512,1452,583,1477,64206-31,71,25,64206-31,OTHER
11693,11695,511,1429,531,1456,tax,20,27,tax,OTHER
11697,11704,1166,1414,1224,1444,withheld,58,30,withheld,OTHER
11734,11739,795,1443,834,1469,social,39,26,social,OTHER
11741,11748,838,1441,886,1465,security,48,24,security,OTHER
11750,11753,890,1441,927,1461,wage,37,20,wage,OTHER
11827,11835,1497,1437,1574,1466,223589.25,77,29,223589.25,OTHER
11837,11841,1625,1459,1667,1479,dept.,42,20,dept.,OTHER
11843,11847,1691,1451,1729,1478,corp.,38,27,corp.,OTHER
11871,11871,1820,1458,1838,1485,a,18,27,a,OTHER
11885,11885,131,1465,145,1489,1,14,24,1,OTHER
11887,11892,161,1459,208,1486,"wages,",47,27,"wages,",OTHER
11911,11911,879,2394,886,2419,2,7,25,2,OTHER
11912,11912,134,1501,148,1523,3,14,22,3,OTHER
11913,11913,1020,1462,1041,1495,6,21,33,6,OTHER
11916,11916,1708,1667,1730,1698,8,22,31,8,OTHER
11917,11921,212,1456,240,1482,"tips,",28,26,"tips,",OTHER
11922,11924,225,1474,256,1498,.19,31,24,.19,OTHER
11925,11929,244,1452,276,1479,other,32,27,other,OTHER
11931,11935,280,1445,331,1475,comp.,51,30,comp.,OTHER
11943,11948,413,1476,452,1507,social,39,31,social,OTHER
11950,11957,457,1475,504,1504,security,47,29,security,OTHER
11959,11961,1111,1455,1129,1484,tax,18,29,tax,OTHER
11963,11970,536,1423,600,1454,withheld,64,31,withheld,OTHER
12007,12015,828,1466,905,1487,185565-35,77,21,185565-35,OTHER
12035,12042,1047,1457,1105,1491,medicare,58,34,medicare,OTHER
12044,12046,509,1474,528,1501,tax,19,27,tax,OTHER
12047,12053,1152,1471,1217,1495,6484.09,65,24,6484.09,OTHER
12214,12221,1135,1452,1206,1482,withheld,71,30,withheld,OTHER
12250,12250,142,1588,156,1610,d,14,22,d,OTHER
12252,12258,1463,1469,1509,1493,control,46,24,control,OTHER
12260,12265,1513,1462,1571,1489,number,58,27,number,OTHER
12280,12280,1268,2170,1285,2196,3,17,26,3,OTHER
12282,12287,167,1498,206,1521,social,39,23,social,OTHER
12291,12298,210,1495,259,1519,security,49,24,security,OTHER
12300,12304,859,1477,902,1501,wages,43,24,wages,OTHER
12373,12373,766,1487,783,1514,5,17,27,5,OTHER
12375,12382,797,1480,855,1508,medicare,58,28,medicare,OTHER
12386,12390,262,1492,308,1517,wages,46,25,wages,OTHER
12392,12394,906,1476,928,1497,and,22,21,and,OTHER
12396,12399,931,1475,958,1496,tips,27,21,tips,OTHER
12515,12523,831,1496,911,1524,223589.25,80,28,223589.25,OTHER
12563,12570,1199,1489,1253,1517,employer,54,28,employer,OTHER
12572,12574,1258,1488,1279,1516,use,21,28,use,OTHER
12576,12579,1284,1485,1316,1514,only,32,29,only,OTHER
12598,12607,1469,1498,1539,1524,employer's,70,26,employer's,OTHER
12609,12613,1542,1495,1583,1523,"name,",41,28,"name,",OTHER
12615,12622,1586,1490,1640,1520,"address,",54,30,"address,",OTHER
12624,12626,1643,1487,1667,1515,and,24,28,and,OTHER
12628,12630,1671,1484,1691,1512,zip,20,28,zip,OTHER
12632,12635,1695,1479,1727,1509,code,32,30,code,OTHER
12655,12663,180,1511,260,1538,185553.33,80,27,185553.33,OTHER
12686,12693,415,1512,473,1543,medicare,58,31,medicare,OTHER
12695,12697,478,1510,497,1538,tax,19,28,tax,OTHER
12699,12706,533,1474,587,1499,withheld,54,25,withheld,OTHER
12708,12712,522,1525,554,1550,5484.,32,25,5484.,OTHER
12714,12715,558,1524,584,1549,09,26,25,09,OTHER
12772,12776,961,1517,1004,1540,dept.,43,23,dept.,OTHER
12777,12781,1025,1509,1070,1536,corp.,45,27,corp.,OTHER
12794,12794,1153,1512,1174,1541,a,21,29,a,OTHER
12840,12844,1504,1519,1566,1546,dixon,62,27,dixon,OTHER
12846,12848,1571,1517,1611,1545,llc,40,28,llc,OTHER
12850,12854,1615,1512,1675,1543,group,60,31,group,OTHER
12870,12870,138,1543,152,1566,5,14,23,5,OTHER
12872,12879,167,1536,228,1564,medicare,61,28,medicare,OTHER
12881,12885,232,1532,274,1559,wages,42,27,wages,OTHER
12887,12889,278,1530,300,1555,and,22,25,and,OTHER
12891,12894,304,1527,333,1553,tips,29,26,tips,OTHER
12932,12939,566,1542,621,1575,employer,55,33,employer,OTHER
12941,12943,626,1542,647,1570,use,21,28,use,OTHER
12945,12948,652,1542,688,1571,only,36,29,only,OTHER
12964,12970,798,1526,844,1551,control,46,25,control,OTHER
12972,12977,848,1520,906,1547,number,58,27,number,OTHER
12998,13006,183,1555,254,1584,223589.25,71,29,223589.25,OTHER
13008,13012,311,1570,358,1600,dept.,47,30,dept.,OTHER
13014,13018,392,1564,432,1594,corp.,40,30,corp.,OTHER
13086,13095,803,1557,872,1583,employer's,69,26,employer's,OTHER
13097,13101,875,1554,917,1583,"name,",42,29,"name,",OTHER
13103,13109,920,1550,965,1581,address,45,31,address,OTHER
13111,13111,969,1549,975,1577,",",6,28,",",OTHER
13113,13115,978,1546,1002,1576,and,24,30,and,OTHER
13117,13119,1005,1544,1026,1573,zip,21,29,zip,OTHER
13121,13124,1029,1538,1069,1570,code,40,32,code,OTHER
13185,13187,1511,1549,1546,1575,773,35,26,773,OTHER
13189,13194,1550,1542,1624,1573,miller,74,31,miller,OTHER
13196,13200,1628,1537,1690,1569,wells,62,32,wells,OTHER
13202,13206,1696,1533,1756,1563,suite,60,30,suite,OTHER
13208,13210,1763,1530,1791,1556,955,28,26,955,OTHER
13227,13233,169,1581,215,1608,control,46,27,control,OTHER
13235,13240,219,1573,277,1603,number,58,30,number,OTHER
13328,13332,839,1581,900,1610,dixon,61,29,dixon,OTHER
13334,13336,907,1577,946,1605,llc,39,28,llc,OTHER
13338,13342,951,1573,1011,1602,group,60,29,group,OTHER
13417,13420,1509,1574,1561,1603,west,52,29,west,OTHER
13422,13434,1566,1560,1713,1599,jonathanshire,147,39,jonathanshire,OTHER
13436,13437,1730,1556,1757,1585,ct,27,29,ct,OTHER
13439,13448,1775,1545,1886,1581,44169-8232,111,36,44169-8232,OTHER
13465,13477,143,1611,245,1634,190employer's,102,23,190employer's,OTHER
13479,13483,248,1609,289,1634,"name,",41,25,"name,",OTHER
13485,13492,292,1604,347,1633,"address,",55,29,"address,",OTHER
13494,13496,349,1601,374,1629,and,25,28,and,OTHER
13498,13500,376,1597,399,1626,zip,23,29,zip,OTHER
13502,13505,401,1591,438,1622,code,37,31,code,OTHER
13567,13569,843,1607,880,1634,773,37,27,773,OTHER
13571,13576,884,1601,957,1633,miller,73,32,miller,OTHER
13578,13582,961,1596,1026,1629,wells,65,33,wells,OTHER
13584,13588,1029,1590,1091,1623,suite,62,33,suite,OTHER
13590,13592,1095,1587,1128,1616,955,33,29,955,OTHER
13683,13692,1732,1612,1805,1648,employee's,73,36,employee's,OTHER
13694,13696,1810,1608,1835,1638,ssa,25,30,ssa,OTHER
13698,13703,1840,1600,1904,1635,number,64,35,number,OTHER
13725,13729,190,1634,250,1659,dixon,60,25,dixon,OTHER
13731,13733,257,1633,296,1659,llc,39,26,llc,OTHER
13735,13739,302,1629,360,1658,group,58,29,group,OTHER
13822,13825,843,1632,894,1660,west,51,28,west,OTHER
13827,13839,901,1619,1047,1656,jonathanshire,146,37,jonathanshire,OTHER
13841,13842,1064,1615,1092,1643,ct,28,28,ct,OTHER
13844,13853,1110,1604,1224,1640,44169-8232,114,36,44169-8232,OTHER
13905,13914,1482,1635,1549,1666,employer's,67,31,employer's,OTHER
13916,13918,1554,1633,1577,1659,fed,23,26,fed,OTHER
13920,13921,1582,1631,1596,1657,id,14,26,id,OTHER
13923,13928,1600,1626,1652,1655,number,52,29,number,OTHER
13952,13954,195,1665,231,1693,773,36,28,773,OTHER
13956,13961,235,1658,310,1690,miller,75,32,miller,OTHER
13963,13967,313,1653,377,1684,wells,64,31,wells,OTHER
13969,13973,382,1647,443,1678,suite,61,31,suite,OTHER
13975,13977,448,1644,487,1672,955,39,28,955,OTHER
14135,14144,1516,1649,1603,1682,30-5841370,87,33,30-5841370,OTHER
14161,14161,1043,1727,1064,1757,8,21,30,8,OTHER
14163,14171,1736,1663,1795,1697,allocated,59,34,allocated,OTHER
14173,14181,1839,1672,1913,1704,223589.25,74,32,223589.25,OTHER
14430,14433,1800,1661,1836,1694,tips,36,33,tips,OTHER
14581,14590,1067,1670,1141,1703,employee's,74,33,employee's,OTHER
14592,14594,1146,1667,1169,1696,ssa,23,29,ssa,OTHER
14596,14601,1174,1661,1229,1693,number,55,32,number,OTHER
14625,14628,195,1690,245,1718,west,50,28,west,OTHER
14630,14642,253,1675,398,1713,jonathanshire,145,38,jonathanshire,OTHER
14644,14645,416,1672,443,1699,ct,27,27,ct,OTHER
14647,14656,461,1662,568,1695,44169-8232,107,33,44169-8232,OTHER
14713,14722,816,1693,884,1724,employer's,68,31,employer's,OTHER
14727,14729,889,1691,914,1718,fed,25,27,fed,OTHER
14731,14732,918,1690,930,1716,id,12,26,id,OTHER
14734,14739,935,1686,992,1715,number,57,29,number,OTHER
14809,14817,1521,1700,1594,1724,185553-33,73,24,185553-33,OTHER
14935,14944,849,1710,936,1737,30-5841370,87,27,30-5841370,OTHER
14963,14971,1070,1723,1130,1755,allocated,60,32,allocated,OTHER
14973,14981,1174,1730,1247,1761,223589.25,73,31,223589.25,OTHER
15143,15146,1135,1721,1170,1750,tips,35,29,tips,OTHER
15215,15216,1715,1723,1738,1749,10,23,26,10,OTHER
15218,15226,1745,1717,1813,1748,dependent,68,31,dependent,OTHER
15228,15231,1818,1714,1845,1743,care,27,29,care,OTHER
15232,15234,1843,1728,1875,1751,197,32,23,197,OTHER
15235,15242,1849,1707,1901,1739,benefits,52,32,benefits,OTHER
15297,15306,434,1726,509,1759,employee's,75,33,employee's,OTHER
15308,15310,513,1723,538,1750,ssa,25,27,ssa,OTHER
15312,15317,542,1717,603,1747,number,61,30,number,OTHER
15355,15360,822,1751,860,1775,social,38,24,social,OTHER
15362,15369,864,1750,912,1775,security,48,25,security,OTHER
15371,15373,915,1750,932,1774,tip,17,24,tip,OTHER
15442,15442,1459,1744,1476,1772,9,17,28,9,OTHER
15444,15455,1490,1738,1562,1769,verification,72,31,verification,OTHER
15457,15460,1567,1736,1604,1763,code,37,27,code,OTHER
15478,15478,155,1756,169,1778,b,14,22,b,OTHER
15480,15489,187,1749,257,1777,employer's,70,28,employer's,OTHER
15513,15522,202,1762,292,1794,30-5841370,90,32,30-5841370,OTHER
15524,15526,261,1746,285,1772,fed,24,26,fed,OTHER
15528,15529,289,1744,303,1770,id,14,26,id,OTHER
15531,15536,306,1736,365,1768,number,59,32,number,OTHER
15724,15725,1902,1756,1922,1785,12,20,29,12,OTHER
15728,15730,1749,1770,1771,1799,see,22,29,see,OTHER
15732,15743,1775,1765,1848,1798,instructions,73,33,instructions,OTHER
15745,15747,1852,1763,1869,1792,for,17,29,for,OTHER
15749,15751,1873,1760,1897,1789,box,24,29,box,OTHER
15753,15753,1837,1805,1846,1832,1,9,27,1,OTHER
15809,15817,439,1779,498,1810,allocated,59,31,allocated,OTHER
15819,15822,504,1778,538,1807,tips,34,29,tips,OTHER
15823,15828,542,1788,585,1817,223589,43,29,223589,OTHER
15830,15830,1253,2169,1264,2195,.,11,26,.,OTHER
15832,15833,597,1786,609,1811,25,12,25,25,OTHER
15900,15901,1050,1780,1074,1808,10,24,28,10,OTHER
15903,15911,1078,1775,1146,1807,dependent,68,32,dependent,OTHER
15913,15916,1151,1772,1177,1801,care,26,29,care,OTHER
15917,15919,1179,1786,1211,1813,197,32,27,197,OTHER
15921,15928,1182,1765,1234,1797,benefits,52,32,benefits,OTHER
15955,15956,1465,1796,1487,1819,11,22,23,11,OTHER
15958,15969,1497,1791,1579,1818,nonqualified,82,27,nonqualified,OTHER
15971,15975,1583,1786,1627,1813,plans,44,27,plans,OTHER
15998,16003,193,1803,232,1829,social,39,26,social,OTHER
16005,16012,236,1799,284,1824,security,48,25,security,OTHER
16014,16017,288,1797,313,1820,tips,25,23,tips,OTHER
16041,16049,206,1814,286,1840,185553.33,80,26,185553.33,OTHER
16129,16129,793,1803,810,1828,9,17,25,9,OTHER
16131,16142,824,1797,898,1827,verification,74,30,verification,OTHER
16144,16147,903,1793,941,1821,code,38,28,code,OTHER
16265,16265,1172,1868,1181,1888,1,9,20,1,OTHER
16267,16270,1851,1803,1893,1830,7905,42,27,7905,OTHER
16324,16325,416,1837,440,1864,10,24,27,10,OTHER
16327,16335,445,1831,516,1862,dependent,71,31,dependent,OTHER
16337,16340,520,1828,547,1854,care,27,26,care,OTHER
16341,16343,546,1841,577,1865,197,31,24,197,OTHER
16346,16353,551,1823,603,1850,benefits,52,27,benefits,OTHER
16417,16419,1720,1771,1744,1800,12a,24,29,12a,OTHER
16421,16423,1085,1831,1106,1858,see,21,27,see,OTHER
16425,16436,1111,1824,1183,1857,instructions,72,33,instructions,OTHER
16438,16440,1188,1822,1203,1850,for,15,28,for,OTHER
16442,16444,1208,1818,1232,1848,box,24,30,box,OTHER
16446,16447,1237,1815,1255,1844,12,18,29,12,OTHER
16507,16509,1723,1830,1756,1860,126,33,30,126,OTHER
16622,16623,799,1857,817,1877,11,18,20,11,OTHER
16625,16636,832,1847,915,1876,nonqualified,83,29,nonqualified,OTHER
16711,16712,1469,1852,1489,1874,14,20,22,14,OTHER
16714,16718,1507,1850,1538,1869,other,31,19,other,OTHER
16738,16738,166,1857,181,1882,9,15,25,9,OTHER
16740,16751,196,1851,269,1880,verification,73,29,verification,OTHER
16753,16756,274,1850,303,1875,code,29,25,code,OTHER
16839,16841,864,1869,894,1889,230,30,20,230,OTHER
16843,16847,917,1844,959,1871,plans,42,27,plans,OTHER
16883,16883,541,1921,549,1948,1,8,27,1,OTHER
16885,16888,1185,1866,1221,1887,7905,36,21,7905,OTHER
16954,16955,1727,1879,1740,1908,13,13,29,13,OTHER
16957,16960,1742,1878,1763,1907,stat,21,29,stat,OTHER
16962,16964,1766,1876,1787,1905,emp,21,29,emp,OTHER
16966,16969,1790,1874,1810,1904,ret.,20,30,ret.,OTHER
16971,16974,1814,1871,1850,1902,plan,36,31,plan,OTHER
16976,16978,1856,1869,1872,1898,3rd,16,29,3rd,OTHER
16980,16984,1876,1866,1903,1897,party,27,31,party,OTHER
16986,16989,1907,1863,1928,1893,sick,21,30,sick,OTHER
16991,16993,1933,1858,1966,1891,pay,33,33,pay,OTHER
17048,17050,1054,1833,1080,1860,12a,26,27,12a,OTHER
17052,17054,452,1885,473,1914,see,21,29,see,OTHER
17056,17067,478,1879,549,1912,instructions,71,33,instructions,OTHER
17069,17071,554,1877,570,1905,for,16,28,for,OTHER
17073,17075,575,1873,600,1902,box,25,29,box,OTHER
17077,17078,605,1871,621,1898,12,16,27,12,OTHER
17141,17143,1059,1893,1091,1920,126,32,27,126,OTHER
17164,17165,171,1910,192,1935,11,21,25,11,OTHER
17167,17178,203,1904,284,1933,nonqualified,81,29,nonqualified,OTHER
17180,17184,287,1899,330,1926,plans,43,27,plans,OTHER
17256,17257,804,1909,823,1931,14,19,22,14,OTHER
17259,17263,841,1905,875,1925,other,34,20,other,OTHER
17291,17293,1062,1912,1094,1943,72d,32,31,72d,OTHER
17295,17298,1125,1929,1145,1960,ret.,20,31,ret.,OTHER
17299,17299,1178,1905,1184,1934,1,6,29,1,OTHER
17300,17303,1148,1925,1187,1958,plan,39,33,plan,OTHER
17307,17309,1190,1923,1205,1950,ard,15,27,ard,OTHER
17310,17312,1189,1902,1226,1933,686,37,31,686,OTHER
17367,17369,426,1941,457,1969,126,31,28,126,OTHER
17370,17370,542,1950,549,1981,1,7,31,1,OTHER
17372,17374,555,1948,593,1979,740,38,31,740,OTHER
17447,17450,554,1917,593,1945,7905,39,28,7905,OTHER
17522,17523,1063,1937,1074,1964,13,11,27,13,OTHER
17525,17529,1077,1934,1108,1963,state,31,29,state,OTHER
17542,17543,1190,1924,1203,1954,on,13,30,on,OTHER
17544,17548,1211,1923,1238,1950,party,27,27,party,OTHER
17550,17553,1243,1920,1262,1950,sick,19,30,sick,OTHER
17555,17557,1267,1915,1298,1948,pay,31,33,pay,OTHER
17576,17578,1475,1941,1503,1965,elf,28,24,elf,OTHER
17580,17588,1507,1935,1577,1963,employees,70,28,employees,OTHER
17590,17594,1580,1929,1621,1958,"name,",41,29,"name,",OTHER
17596,17602,1624,1923,1674,1954,address,50,31,address,OTHER
17604,17606,1678,1919,1701,1948,and,23,29,and,OTHER
17608,17610,1705,1914,1727,1945,zip,22,31,zip,OTHER
17612,17615,1731,1907,1768,1941,code,37,34,code,OTHER
17636,17637,174,1958,199,1987,14,25,29,14,OTHER
17639,17643,212,1955,258,1982,other,46,27,other,OTHER
17824,17830,1541,1968,1628,2000,michael,87,32,michael,OTHER
17832,17838,1644,1962,1725,1993,spencer,81,31,spencer,OTHER
17894,17895,429,1992,440,2022,13,11,30,13,OTHER
17897,17900,445,1991,463,2022,stat,18,31,stat,OTHER
17902,17904,469,1989,489,2021,ema,20,32,ema,OTHER
17906,17908,494,1988,507,2020,ret,13,32,ret,OTHER
17910,17910,927,2209,931,2232,.,4,23,.,OTHER
17912,17915,518,1985,552,2018,plan,34,33,plan,OTHER
17917,17919,558,1983,574,2015,ard,16,32,ard,OTHER
17921,17925,580,1980,605,2013,party,25,33,party,OTHER
17927,17930,611,1977,629,2010,sick,18,33,sick,OTHER
17932,17934,635,1973,664,2008,pay,29,35,pay,OTHER
17952,17954,813,1997,838,2021,elf,25,24,elf,OTHER
17956,17964,843,1992,910,2020,employees,67,28,employees,OTHER
17966,17970,915,1988,956,2017,"name,",41,29,"name,",OTHER
17972,17978,960,1982,1009,2014,address,49,32,address,OTHER
17980,17982,1013,1979,1035,2009,and,22,30,and,OTHER
17984,17986,1039,1976,1060,2006,zip,21,30,zip,OTHER
17988,17991,1064,1970,1102,2004,code,38,34,code,OTHER
18048,18052,1547,1996,1608,2027,14193,61,31,14193,OTHER
18054,18060,1613,1990,1697,2021,richard,84,31,richard,OTHER
18062,18065,1701,1988,1751,2015,camp,50,27,camp,OTHER
18187,18193,876,2027,961,2055,michael,85,28,michael,OTHER
18195,18201,979,2021,1061,2051,spencer,82,30,spencer,OTHER
18274,18277,1550,2024,1598,2052,port,48,28,port,OTHER
18279,18283,1605,2017,1663,2047,terry,58,30,terry,OTHER
18285,18286,1681,2013,1707,2040,wv,26,27,wv,OTHER
18288,18297,1738,2000,1849,2035,38332-8400,111,35,38332-8400,OTHER
18318,18320,183,2053,209,2077,elf,26,24,elf,OTHER
18322,18330,213,2048,282,2076,employees,69,28,employees,OTHER
18332,18335,286,2045,318,2072,name,32,27,name,OTHER
18337,18337,322,2044,327,2069,",",5,25,",",OTHER
18339,18345,331,2038,380,2068,address,49,30,address,OTHER
18347,18349,384,2035,407,2064,and,23,29,and,OTHER
18351,18353,411,2032,432,2061,zip,21,29,zip,OTHER
18355,18358,436,2025,475,2059,code,39,34,code,OTHER
18420,18424,882,2054,942,2083,14193,60,29,14193,OTHER
18426,18432,948,2049,1030,2079,richard,82,30,richard,OTHER
18434,18437,1036,2047,1083,2073,camp,47,26,camp,OTHER
18449,18458,1072,2059,1182,2094,38332-8400,110,35,38332-8400,OTHER
18504,18508,1779,2062,1812,2087,state,33,25,state,OTHER
18510,18518,1617,2089,1696,2117,45-04-585,79,28,45-04-585,OTHER
18520,18529,1616,2075,1679,2105,employers',63,30,employers',OTHER
18531,18535,1682,2071,1711,2096,state,29,25,state,OTHER
18537,18538,1714,2070,1726,2092,id,12,22,id,OTHER
18540,18541,1728,2068,1743,2091,no,15,23,no,OTHER
18543,18544,1745,2065,1765,2089,16,20,24,16,OTHER
18546,18550,1525,2087,1565,2114,state,40,27,state,OTHER
18552,18557,1814,2059,1861,2084,"wages,",47,25,"wages,",OTHER
18559,18563,1863,2058,1893,2082,"tips,",30,24,"tips,",OTHER
18565,18568,1895,2057,1927,2082,etc.,32,25,etc.,OTHER
18597,18603,231,2085,314,2113,michael,83,28,michael,OTHER
18605,18611,329,2078,413,2110,spencer,84,32,spencer,OTHER
18691,18694,884,2083,933,2110,port,49,27,port,OTHER
18696,18700,940,2076,997,2106,terry,57,30,terry,OTHER
18702,18703,1015,2071,1043,2099,wv,28,28,wv,OTHER
18731,18735,234,2112,293,2140,14193,59,28,14193,OTHER
18737,18743,299,2106,382,2135,richard,83,29,richard,OTHER
18745,18748,387,2102,435,2130,camp,48,28,camp,OTHER
18947,18948,1749,2113,1773,2143,18,24,30,18,OTHER
18950,18954,1782,2110,1816,2140,local,34,30,local,OTHER
18956,18960,1821,2109,1859,2138,wages,38,29,wages,OTHER
18962,18962,1863,2109,1866,2136,",",3,27,",",OTHER
18964,18967,1870,2109,1889,2136,tips,19,27,tips,OTHER
18969,18969,1893,2109,1896,2136,",",3,27,",",OTHER
18971,18973,1900,2109,1932,2137,etc,32,28,etc,OTHER
19002,19005,236,2139,284,2164,port,48,25,port,OTHER
19007,19011,291,2133,349,2162,terry,58,29,terry,OTHER
19013,19014,367,2127,393,2156,wv,26,29,wv,OTHER
19015,19024,422,2117,533,2151,38332-8400,111,34,38332-8400,OTHER
19106,19115,951,2128,1014,2157,employers',63,29,employers',OTHER
19117,19121,1018,2126,1044,2153,state,26,27,state,OTHER
19123,19124,1048,2125,1058,2151,id,10,26,id,OTHER
19126,19127,1062,2123,1076,2150,no,14,27,no,OTHER
19129,19130,1079,2122,1100,2148,16,21,26,16,OTHER
19132,19136,1114,2119,1146,2146,state,32,27,state,OTHER
19138,19143,1149,2117,1195,2144,"wages,",46,27,"wages,",OTHER
19145,19149,1198,2116,1225,2141,"tips,",27,25,"tips,",OTHER
19151,19154,1228,2115,1262,2139,etc.,34,24,etc.,OTHER
19177,19178,1494,2138,1516,2164,17,22,26,17,OTHER
19180,19184,1532,2133,1564,2159,state,32,26,state,OTHER
19185,19188,1559,2151,1589,2176,5328,30,25,5328,OTHER
19189,19194,1568,2128,1616,2154,income,48,26,income,OTHER
19415,19417,1593,2148,1623,2173,.48,30,25,.48,OTHER
19418,19420,1619,2125,1647,2149,tax,28,24,tax,OTHER
19552,19560,951,2148,1030,2180,45-04-585,79,32,45-04-585,OTHER
19562,19563,1083,2172,1109,2204,18,26,32,18,OTHER
19565,19569,1116,2170,1149,2200,local,33,30,local,OTHER
19571,19575,1154,2169,1192,2197,wages,38,28,wages,OTHER
19577,19577,1197,2169,1200,2195,",",3,26,",",OTHER
19579,19582,1204,2169,1221,2195,tips,17,26,tips,OTHER
19584,19584,1226,2169,1231,2195,",",5,26,",",OTHER
19586,19588,1235,2169,1248,2195,etc,13,26,etc,OTHER
19590,19590,621,2216,638,2244,.,17,28,.,OTHER
19664,19665,1753,2162,1780,2192,20,27,30,20,OTHER
19667,19674,1786,2160,1834,2192,locality,48,32,locality,OTHER
19675,19676,1864,2167,1876,2195,ne,12,28,ne,OTHER
19677,19680,1839,2158,1890,2190,name,51,32,name,OTHER
19687,19692,1881,2169,1933,2197,hansen,52,28,hansen,OTHER
19694,19698,1938,2166,1977,2197,cliff,39,31,cliff,OTHER
19734,19743,303,2185,365,2213,employers',62,28,employers',OTHER
19746,19747,1624,2180,1640,2203,ta,16,23,ta,OTHER
19751,19752,399,2182,410,2209,id,11,27,id,OTHER
19754,19756,415,2180,443,2208,no.,28,28,no.,OTHER
19758,19759,447,2178,469,2206,16,22,28,16,OTHER
19761,19765,481,2175,512,2204,state,31,29,state,OTHER
19767,19772,517,2173,560,2202,"wages,",43,29,"wages,",OTHER
19774,19778,565,2171,591,2198,"tips,",26,27,"tips,",OTHER
19780,19783,596,2168,630,2195,etc.,34,27,etc.,OTHER
19807,19808,195,2202,217,2225,15,22,23,15,OTHER
19810,19814,868,2193,899,2217,state,31,24,state,OTHER
19815,19823,304,2203,384,2238,45-04-585,80,35,45-04-585,OTHER
19900,19904,230,2201,269,2223,state,39,22,state,OTHER
19906,19911,902,2186,950,2213,income,48,27,income,OTHER
19913,19915,953,2180,982,2206,tax,29,26,tax,OTHER
19988,19989,1498,2189,1520,2212,19,22,23,19,OTHER
19991,19995,1535,2186,1571,2210,local,36,24,local,OTHER
19997,20002,1574,2182,1621,2208,income,47,26,income,OTHER
20129,20132,893,2210,923,2236,5328,30,26,5328,OTHER
20134,20134,292,2314,294,2340,.,2,26,.,OTHER
20136,20137,934,2206,957,2231,48,23,25,48,OTHER
20160,20161,1087,2222,1114,2251,20,27,29,20,OTHER
20163,20167,483,2224,518,2253,local,35,29,local,OTHER
20172,20175,1176,2219,1223,2250,name,47,31,name,OTHER
20250,20255,1766,2224,1816,2249,filing,50,25,filing,OTHER
20273,20276,1911,2209,1958,2236,copy,47,27,copy,OTHER
20337,20338,451,2227,475,2254,18,24,27,18,OTHER
20340,20344,1666,2231,1725,2260,local,59,29,local,OTHER
20346,20350,523,2221,560,2251,wages,37,30,wages,OTHER
20352,20352,564,2221,568,2248,",",4,27,",",OTHER
20354,20357,573,2219,590,2247,tips,17,28,tips,OTHER
20359,20359,594,2219,598,2246,",",4,27,",",OTHER
20361,20363,603,2218,616,2245,etc,13,27,etc,OTHER
20452,20457,1216,2229,1268,2257,hansen,52,28,hansen,OTHER
20459,20463,1273,2224,1320,2254,cliff,47,30,cliff,OTHER
20497,20500,1609,2235,1641,2262,city,32,27,city,OTHER
20502,20503,1646,2234,1661,2261,or,15,27,or,OTHER
20505,20509,870,2244,906,2270,local,36,26,local,OTHER
20537,20541,238,2246,270,2272,state,32,26,state,OTHER
20543,20548,274,2240,321,2269,income,47,29,income,OTHER
20550,20552,325,2234,354,2263,tax,29,29,tax,OTHER
20625,20626,833,2249,855,2273,19,22,24,19,OTHER
20628,20632,241,2299,276,2327,local,35,28,local,OTHER
20633,20640,899,2254,970,2284,38116.94,71,30,38116.94,OTHER
20767,20772,910,2240,957,2266,income,47,26,income,OTHER
20774,20776,959,2238,980,2261,tax,21,23,tax,OTHER
20818,20821,1245,2264,1296,2292,copy,51,28,copy,OTHER
20875,20878,1699,2252,1760,2279,wage,61,27,wage,OTHER
20880,20882,1775,2244,1814,2276,and,39,32,and,OTHER
20884,20886,1839,2239,1877,2264,tax,38,25,tax,OTHER
20888,20891,1904,2263,1983,2296,2018,79,33,2018,OTHER
20921,20924,245,2266,275,2291,5328,30,25,5328,OTHER
20926,20928,279,2261,309,2289,.48,30,28,.48,OTHER
20953,20954,455,2278,479,2305,20,24,27,20,OTHER
20956,20963,1121,2221,1171,2251,locality,50,30,locality,OTHER
20965,20970,584,2285,636,2310,hansen,52,25,hansen,OTHER
20972,20975,543,2273,589,2303,name,46,30,name,OTHER
20977,20981,640,2281,677,2310,cliff,37,29,cliff,OTHER
21127,21135,1695,2270,1790,2302,statement,95,32,statement,OTHER
21161,21161,210,2304,227,2330,9,17,26,9,OTHER
21163,21167,1752,2314,1784,2343,local,32,29,local,OTHER
21269,21276,957,2291,1038,2318,nv.state,81,27,nv.state,OTHER
21278,21283,1100,2283,1152,2307,filing,52,24,filing,OTHER
21285,21287,1174,2300,1211,2324,tax,37,24,tax,OTHER
21341,21343,1512,2300,1575,2329,w-2,63,29,w-2,OTHER
21373,21377,250,2314,287,2341,38116,37,27,38116,OTHER
21378,21383,280,2294,327,2324,income,47,30,income,OTHER
21424,21425,299,2311,324,2339,94,25,28,94,OTHER
21427,21429,331,2291,358,2320,tax,27,29,tax,OTHER
21468,21471,612,2324,658,2348,copy,46,24,copy,OTHER
21529,21532,1035,2311,1093,2335,wage,58,24,wage,OTHER
21534,21536,1110,2303,1141,2331,and,31,28,and,OTHER
21562,21565,1243,2322,1318,2354,2018,75,32,2018,OTHER
21603,21609,314,2345,394,2377,federal,80,32,federal,OTHER
21629,21634,467,2339,510,2359,filing,43,20,filing,OTHER
21713,21721,1030,2332,1119,2363,statement,89,31,statement,OTHER
21772,21775,1511,2337,1541,2362,copy,30,25,copy,OTHER
21779,21780,1553,2335,1568,2359,to,15,24,to,OTHER
21782,21783,1570,2333,1585,2358,be,15,25,be,OTHER
21785,21789,1587,2331,1612,2357,filed,25,26,filed,OTHER
21791,21794,949,2385,973,2413,with,24,28,with,OTHER
21796,21805,1642,2321,1708,2352,employee's,66,31,employee's,OTHER
21807,21810,1711,2319,1736,2347,city,25,28,city,OTHER
21812,21813,1739,2318,1749,2344,or,10,26,or,OTHER
21821,21826,1787,2310,1831,2340,income,44,30,income,OTHER
21828,21830,1834,2308,1854,2336,tax,20,28,tax,OTHER
21832,21838,1858,2302,1923,2333,returnb,65,31,returnb,OTHER
21840,21842,1927,2300,1949,2327,no.,22,27,no.,OTHER
21844,21852,1954,2293,2020,2324,1545-0008,66,31,1545-0008,OTHER
21905,21908,394,2365,450,2393,wage,56,28,wage,OTHER
21910,21912,478,2358,511,2384,and,33,26,and,OTHER
21914,21916,543,2355,577,2377,tax,34,22,tax,OTHER
21918,21921,608,2379,679,2407,2018,71,28,2018,OTHER
21969,21971,847,2356,909,2385,w-2,62,29,w-2,OTHER
22028,22030,1229,2363,1256,2390,omb,27,27,omb,OTHER
22032,22034,1261,2360,1282,2386,no.,21,26,no.,OTHER
22036,22044,1286,2351,1354,2383,1545-0008,68,32,1545-0008,OTHER
22097,22101,1047,2376,1075,2405,state,28,29,state,OTHER
22161,22164,845,2395,875,2421,copy,30,26,copy,OTHER
22168,22169,889,2393,902,2418,to,13,25,to,OTHER
22171,22172,905,2391,918,2417,be,13,26,be,OTHER
22174,22178,921,2388,945,2415,filed,24,27,filed,OTHER
22180,22183,322,2442,349,2466,with,27,24,with,OTHER
22185,22194,977,2379,1043,2411,employee's,66,32,employee's,OTHER
22202,22207,1079,2372,1121,2402,income,42,30,income,OTHER
22209,22211,1126,2370,1146,2398,tax,20,28,tax,OTHER
22213,22218,1151,2366,1196,2395,return,45,29,return,OTHER
22244,22246,218,2412,282,2445,w-2,64,33,w-2,OTHER
22273,22276,217,2451,248,2474,copy,31,23,copy,OTHER
22278,22278,249,2450,260,2471,b,11,21,b,OTHER
22280,22281,262,2449,276,2470,to,14,21,to,OTHER
22283,22284,277,2447,294,2469,be,17,22,be,OTHER
22286,22290,295,2444,321,2468,filed,26,24,filed,OTHER
22297,22306,350,2435,417,2464,employee's,67,29,employee's,OTHER
22308,22314,418,2431,463,2458,federal,45,27,federal,OTHER
22316,22321,464,2427,510,2454,income,46,27,income,OTHER
22323,22325,512,2425,534,2450,tax,22,25,tax,OTHER
22327,22332,536,2420,582,2448,return,46,28,return,OTHER
22334,22336,596,2416,626,2442,omb,30,26,omb,OTHER
22338,22340,628,2414,652,2439,no.,24,25,no.,OTHER
22342,22350,654,2408,721,2436,1545-0008,67,28,1545-0008,OTHER
