start_index,end_index,x_top_left,y_top_left,x_bottom_right,y_bottom_right,transcript,box_width,box_height,combined_text,predicted_field
39,39,504,937,527,970,a,23,33,a,OTHER
41,50,536,938,672,973,employee's,136,35,employee's,OTHER
52,57,678,940,745,973,social,67,33,social,OTHER
59,66,751,941,844,973,security,93,32,security,OTHER
68,73,850,941,942,973,number,92,32,number,OTHER
127,131,1583,938,1655,972,"safe,",72,34,"safe,",OTHER
133,141,1661,939,1806,976,accurate.,145,37,accurate.,OTHER
155,159,2092,934,2146,971,visit,54,37,visit,OTHER
161,163,2152,937,2197,972,the,45,35,the,OTHER
165,167,2203,938,2253,973,irs,50,35,irs,OTHER
169,175,2259,938,2372,974,website,113,36,website,OTHER
320,321,1833,961,1894,1006,re,61,45,re,OTHER
323,323,1908,961,1937,1006,~,29,45,~,OTHER
325,328,1954,959,2047,1006,file,93,47,file,OTHER
385,395,703,980,979,1018,358-73-1760,276,38,358-73-1760,ssnOfEmployee
431,433,1272,980,1325,1016,omb,53,36,omb,OTHER
435,437,1331,980,1370,1016,no.,39,36,no.,OTHER
439,447,1376,979,1492,1016,1545-0008,116,37,1545-0008,OTHER
457,461,1582,982,1678,1017,fast!,96,35,fast!,OTHER
463,464,1682,983,1726,1023,us,44,40,us,OTHER
483,484,2093,984,2117,1019,at,24,35,at,OTHER
486,503,2122,984,2351,1022,www.irs.gov/efile.,229,38,www.irs.gov/efile.,OTHER
505,505,114,1032,137,1066,b,23,34,b,OTHER
507,514,147,1033,249,1066,employer,102,33,employer,OTHER
516,529,255,1035,387,1065,identification,132,30,identification,OTHER
531,536,393,1033,477,1064,number,84,31,number,OTHER
538,542,483,1031,555,1063,(ein),72,32,(ein),OTHER
621,626,1447,1036,1533,1065,"wages,",86,29,"wages,",OTHER
628,632,1537,1037,1584,1065,"tips,",47,28,"tips,",OTHER
634,638,1589,1037,1645,1065,other,56,28,other,OTHER
640,651,1649,1035,1806,1064,compensation,157,29,compensation,OTHER
672,678,2002,1036,2085,1065,federal,83,29,federal,OTHER
680,685,2090,1035,2169,1065,income,79,30,income,OTHER
687,689,2174,1034,2209,1063,tax,35,29,tax,OTHER
691,698,2214,1032,2302,1062,withheld,88,30,withheld,OTHER
709,718,220,1071,478,1106,47-8976704,258,35,47-8976704,einEmployerIdentificationNumber
820,824,1501,1073,1625,1106,09566,124,33,09566,box1WagesTipsAndOtherCompensations
826,826,1636,1072,1652,1106,.,16,34,.,box1WagesTipsAndOtherCompensations
828,829,1658,1072,1703,1106,88,45,34,88,box1WagesTipsAndOtherCompensations
866,870,1976,1070,2102,1108,24022,126,38,24022,box2FederalIncomeTaxWithheld
872,872,2109,1070,2126,1108,.,17,38,.,box2FederalIncomeTaxWithheld
874,874,2132,1070,2147,1108,8,15,38,8,box2FederalIncomeTaxWithheld
877,877,117,1122,140,1156,c,23,34,c,OTHER
879,888,148,1123,265,1157,employer's,117,34,employer's,OTHER
890,894,271,1125,340,1157,"name,",69,32,"name,",OTHER
896,903,346,1125,438,1157,"address,",92,32,"address,",OTHER
905,907,445,1124,487,1157,and,42,33,and,OTHER
909,911,493,1123,528,1157,zip,35,34,zip,OTHER
913,916,534,1122,592,1156,code,58,34,code,OTHER
992,997,1451,1127,1516,1159,social,65,32,social,OTHER
999,1006,1521,1126,1602,1159,security,81,33,security,OTHER
1008,1012,1608,1125,1687,1159,wages,79,34,wages,OTHER
1044,1049,2006,1126,2071,1155,social,65,29,social,OTHER
1051,1058,2075,1125,2157,1155,security,82,30,security,OTHER
1060,1062,2162,1124,2196,1155,tax,34,31,tax,OTHER
1064,1071,2200,1122,2285,1154,withheld,85,32,withheld,OTHER
1083,1089,220,1166,404,1206,"dennis,",184,40,"dennis,",employerName
1091,1097,422,1165,608,1206,daniels,186,41,daniels,employerName
1099,1101,634,1164,714,1205,and,80,41,and,employerName
1103,1108,735,1164,892,1205,bishop,157,41,bishop,employerName
1110,1112,920,1165,998,1205,plc,78,40,plc,employerName
1191,1195,1474,1164,1602,1200,94286,128,36,94286,box3SocialSecurityWages
1197,1199,1610,1164,1682,1205,.95,72,41,.95,box3SocialSecurityWages
1238,1241,1978,1164,2076,1199,7212,98,35,7212,box4SocialSecurityTaxWithheld
1243,1243,2083,1165,2099,1199,.,16,34,.,box4SocialSecurityTaxWithheld
1245,1246,2105,1165,2148,1199,95,43,34,95,box4SocialSecurityTaxWithheld
1258,1262,219,1222,352,1263,78463,133,41,78463,employerAddressStreet_name
1264,1270,372,1224,558,1263,roberto,186,39,roberto,employerAddressStreet_name
1272,1275,578,1227,679,1264,neck,101,37,neck,employerAddressStreet_name
1365,1372,1458,1211,1547,1248,medicare,89,37,medicare,OTHER
1374,1378,1553,1213,1626,1248,wages,73,35,wages,OTHER
1380,1382,1632,1211,1671,1248,and,39,37,and,OTHER
1384,1387,1678,1210,1708,1246,tips,30,36,tips,OTHER
1414,1421,2003,1210,2102,1246,medicare,99,36,medicare,OTHER
1423,1425,2108,1210,2141,1247,tax,33,37,tax,OTHER
1427,1434,2147,1211,2236,1250,withheld,89,39,withheld,OTHER
1554,1559,1476,1252,1628,1294,118452,152,42,118452,OTHER
1561,1561,1634,1255,1650,1294,.,16,39,.,OTHER
1563,1564,1657,1255,1711,1294,51,54,39,51,OTHER
1613,1616,2099,1253,2199,1293,3435,100,40,3435,OTHER
1618,1618,2204,1256,2221,1294,.,17,38,.,OTHER
1620,1621,2226,1256,2276,1294,12,50,38,12,OTHER
1633,1637,220,1284,343,1321,south,123,37,south,employerAddressCity
1639,1642,370,1286,474,1325,dawn,104,39,dawn,employerAddressCity
1670,1671,612,1286,653,1318,tn,41,32,tn,employerAddressState
1679,1688,737,1282,990,1324,23890-1299,253,42,23890-1299,employerAddressZip
1739,1744,1451,1298,1513,1334,social,62,36,social,OTHER
1746,1753,1520,1300,1602,1335,security,82,35,security,OTHER
1755,1758,1608,1298,1657,1335,tips,49,37,tips,OTHER
1792,1800,2004,1298,2102,1331,allocated,98,33,allocated,OTHER
1802,1805,2108,1299,2146,1334,tips,38,35,tips,OTHER
1925,1930,1474,1345,1625,1383,94286.,151,38,94286.,OTHER
1932,1933,1632,1346,1684,1384,95,52,38,95,OTHER
1986,1991,2104,1345,2249,1385,118452,145,40,118452,OTHER
1993,1993,2256,1346,2271,1385,.,15,39,.,OTHER
1995,1996,2278,1345,2328,1386,51,50,41,51,OTHER
1999,1999,118,1393,140,1422,d,22,29,d,OTHER
2001,2007,148,1394,227,1423,control,79,29,control,OTHER
2009,2014,231,1395,321,1423,number,90,28,number,OTHER
2114,2125,1449,1393,1569,1426,verification,120,33,verification,OTHER
2127,2130,1574,1390,1632,1421,code,58,31,code,OTHER
2160,2161,1934,1394,1959,1418,10,25,24,10,OTHER
2163,2171,2004,1395,2125,1423,dependent,121,28,dependent,OTHER
2173,2176,2129,1395,2178,1423,care,49,28,care,OTHER
2178,2185,2182,1392,2271,1422,benefits,89,30,benefits,OTHER
2197,2197,219,1435,239,1464,8,20,29,8,OTHER
2199,2199,245,1436,265,1465,!,20,29,!,OTHER
2365,2367,2098,1440,2165,1472,145,67,32,145,OTHER
2370,2370,118,1486,137,1514,e,19,28,e,OTHER
2372,2381,149,1486,271,1514,employee's,122,28,employee's,OTHER
2383,2387,275,1487,317,1513,first,42,26,first,OTHER
2389,2392,321,1486,385,1512,name,64,26,name,OTHER
2394,2396,389,1485,431,1511,and,42,26,and,OTHER
2398,2404,435,1483,486,1510,initial,51,27,initial,OTHER
2417,2420,626,1485,675,1510,last,49,25,last,OTHER
2422,2425,678,1485,742,1510,name,64,25,name,OTHER
2472,2476,1299,1478,1361,1512,suff.,62,34,suff.,OTHER
2478,2479,1379,1477,1413,1510,11,34,33,11,OTHER
2481,2492,1449,1483,1582,1514,nonqualified,133,31,nonqualified,OTHER
2494,2498,1587,1483,1654,1513,plans,67,30,plans,OTHER
2531,2533,1935,1482,1976,1512,12a,41,30,12a,OTHER
2535,2537,2008,1484,2050,1512,see,42,28,see,OTHER
2539,2550,2055,1485,2195,1512,instructions,140,27,instructions,OTHER
2552,2554,2200,1485,2233,1512,for,33,27,for,OTHER
2556,2558,2238,1484,2286,1511,box,48,27,box,OTHER
2560,2561,2290,1483,2310,1511,12,20,28,12,OTHER
2684,2686,1476,1544,1550,1575,123,74,31,123,OTHER
2732,2733,2004,1542,2049,1571,gg,45,29,gg,OTHER
2742,2745,2098,1542,2199,1576,5223,101,34,5223,OTHER
2758,2762,222,1573,363,1613,tyler,141,40,tyler,employeeName
2778,2783,445,1571,623,1612,miller,178,41,miller,employeeName
2909,2911,1933,1581,1976,1622,12b,43,41,12b,OTHER
3024,3025,1379,1591,1410,1619,13,31,28,13,OTHER
3027,3035,1415,1589,1501,1619,statutory,86,30,statutory,OTHER
3038,3047,1581,1593,1684,1622,retirement,103,29,retirement,OTHER
3056,3066,1745,1594,1843,1621,third-party,98,27,third-party,OTHER
3181,3187,1413,1616,1487,1640,employe,74,24,employe,OTHER
3193,3196,1578,1623,1624,1652,plan,46,29,plan,OTHER
3211,3214,1746,1618,1783,1641,sick,37,23,sick,OTHER
3216,3218,1784,1620,1824,1644,pay,40,24,pay,OTHER
3229,3233,217,1654,365,1694,00771,148,40,00771,OTHER
3235,3239,391,1654,539,1696,perez,148,42,perez,OTHER
3241,3248,564,1653,801,1696,crescent,237,43,crescent,OTHER
3250,3254,827,1652,972,1696,suite,145,44,suite,OTHER
3256,3258,1004,1651,1090,1694,928,86,43,928,OTHER
3399,3401,2098,1661,2162,1690,851,64,29,851,OTHER
3413,3424,216,1719,564,1764,desireehaven,348,45,desireehaven,OTHER
3457,3458,712,1718,768,1755,wy,56,37,wy,OTHER
3475,3484,889,1721,1179,1762,40021-1994,290,41,40021-1994,OTHER
3514,3515,1378,1705,1411,1738,14,33,33,14,OTHER
3517,3521,1449,1704,1505,1734,other,56,30,other,OTHER
3565,3566,1935,1703,1954,1739,12,19,36,12,OTHER
3568,3568,1961,1703,1975,1738,c,14,35,c,OTHER
3740,3740,2018,1769,2035,1794,s,17,25,s,OTHER
3745,3747,2100,1763,2173,1799,700,73,36,700,OTHER
3920,3921,2002,1877,2051,1909,ee,49,32,ee,OTHER
3922,3924,2100,1869,2175,1913,707,75,44,707,OTHER
3926,3926,116,1934,136,1965,1,20,31,1,OTHER
3928,3937,150,1931,272,1963,employee's,122,32,employee's,OTHER
3939,3945,278,1931,365,1961,address,87,30,address,OTHER
3947,3949,371,1931,413,1960,and,42,29,and,OTHER
3951,3953,418,1931,455,1960,zip,37,29,zip,OTHER
3955,3958,460,1932,522,1961,code,62,29,code,OTHER
3960,3961,110,1954,137,1989,15,27,35,15,OTHER
3963,3967,148,1949,207,1990,state,59,41,state,OTHER
3969,3978,260,1960,378,1992,employer's,118,32,employer's,OTHER
3980,3984,384,1961,437,1993,state,53,32,state,OTHER
3986,3987,443,1961,466,1993,id,23,32,id,OTHER
3989,3994,472,1959,561,1994,number,89,35,number,OTHER
4020,4021,756,1957,790,1994,16,34,37,16,OTHER
4023,4027,797,1958,851,1994,state,54,36,state,OTHER
4029,4034,858,1958,933,1994,"wages,",75,36,"wages,",OTHER
4036,4040,939,1958,984,1994,"tips,",45,36,"tips,",OTHER
4042,4045,990,1957,1037,1994,etc.,47,37,etc.,OTHER
4049,4050,1124,1955,1155,1995,17,31,40,17,OTHER
4052,4056,1162,1956,1215,1995,state,53,39,state,OTHER
4058,4063,1222,1955,1302,1995,income,80,40,income,OTHER
4065,4067,1308,1953,1352,1993,tax,44,40,tax,OTHER
4078,4079,1479,1955,1508,1994,18,29,39,18,OTHER
4081,4085,1514,1956,1572,1995,local,58,39,local,OTHER
4087,4092,1579,1958,1655,1995,"wages,",76,37,"wages,",OTHER
4094,4098,1661,1958,1707,1995,"tips,",46,37,"tips,",OTHER
4100,4103,1713,1957,1757,1994,etc.,44,37,etc.,OTHER
4117,4118,1864,1958,1897,1994,19,33,36,19,OTHER
4120,4124,1902,1958,1960,1993,local,58,35,local,OTHER
4126,4131,1965,1959,2044,1994,income,79,35,income,OTHER
4133,4135,2049,1962,2084,1995,tax,35,33,tax,OTHER
4146,4147,2222,1961,2252,1993,20,30,32,20,OTHER
4149,4156,2258,1961,2340,1992,locality,82,31,locality,OTHER
4158,4161,2345,1961,2416,1992,name,71,31,name,OTHER
4164,4165,126,2001,177,2038,nd,51,37,nd,OTHER
4182,4191,352,2001,612,2040,817-30-844,260,39,817-30-844,OTHER
4223,4227,754,2001,881,2040,51400,127,39,51400,box16StateWagesTips
4229,4229,887,2002,906,2040,.,19,38,.,box16StateWagesTips
4231,4232,912,2002,962,2041,47,50,39,47,box16StateWagesTips
4252,4255,1125,2000,1221,2041,3137,96,41,3137,box17StateIncomeTax
4257,4257,1228,2000,1245,2041,.,17,41,.,box17StateIncomeTax
4259,4260,1252,1998,1302,2040,65,50,42,65,box17StateIncomeTax
4281,4287,1476,2000,1652,2041,141476.,176,41,141476.,OTHER
4289,4290,1658,2002,1713,2040,96,55,38,96,OTHER
4320,4324,1866,2004,1992,2040,19980,126,36,19980,OTHER
4326,4326,1998,2004,2016,2040,.,18,36,.,OTHER
4328,4329,2022,2005,2072,2041,66,50,36,66,OTHER
4349,4354,2222,2012,2325,2042,hayden,103,30,hayden,OTHER
4356,4361,2343,2009,2448,2041,summit,105,32,summit,OTHER
4365,4366,128,2090,179,2124,dc,51,34,dc,OTHER
4386,4395,351,2087,596,2128,314-18-062,245,41,314-18-062,OTHER
4424,4428,755,2087,881,2128,53801,126,41,53801,OTHER
4430,4430,888,2088,905,2127,.,17,39,.,OTHER
4432,4433,912,2088,954,2127,55,42,39,55,OTHER
4453,4457,1121,2086,1242,2131,2416.,121,45,2416.,OTHER
4459,4460,1249,2086,1294,2129,69,45,43,69,OTHER
4482,4487,1477,2088,1628,2130,125408,151,42,125408,OTHER
4489,4489,1634,2088,1654,2127,.,20,39,.,OTHER
4491,4492,1660,2089,1702,2127,45,42,38,45,OTHER
4521,4525,1864,2089,1991,2129,18476,127,40,18476,OTHER
4527,4527,1998,2089,2013,2128,.,15,39,.,OTHER
4529,4530,2020,2088,2068,2128,09,48,40,09,OTHER
4550,4553,2221,2093,2320,2131,long,99,38,long,OTHER
4555,4558,2344,2093,2448,2135,road,104,42,road,OTHER
4584,4587,364,2146,481,2190,wage,117,44,wage,OTHER
4589,4591,490,2147,574,2190,and,84,43,and,OTHER
4593,4595,581,2147,651,2190,tax,70,43,tax,OTHER
4649,4652,1142,2149,1408,2243,2018,266,94,2018,taxYear
4704,4713,1756,2157,1903,2192,department,147,35,department,OTHER
4715,4716,1909,2158,1935,2192,of,26,34,of,OTHER
4718,4720,1942,2158,1986,2192,the,44,34,the,OTHER
4722,4739,1992,2159,2220,2192,treasury--internal,228,33,treasury--internal,OTHER
4741,4747,2225,2158,2346,2192,revenue,121,34,revenue,OTHER
4749,4755,2351,2157,2449,2192,service,98,35,service,OTHER
4757,4760,103,2213,166,2249,form,63,36,form,OTHER
4762,4764,181,2214,239,2249,w-2,58,35,w-2,OTHER
4775,4783,361,2203,573,2249,statement,212,46,statement,OTHER
4786,4789,108,2254,182,2291,copy,74,37,copy,OTHER
4791,4795,188,2255,272,2291,b--to,84,36,b--to,OTHER
4797,4798,279,2255,321,2291,be,42,36,be,OTHER
4800,4804,327,2256,402,2291,filed,75,35,filed,OTHER
4806,4809,408,2256,475,2291,with,67,35,with,OTHER
4811,4820,481,2256,657,2292,employee's,176,36,employee's,OTHER
4822,4828,664,2257,818,2293,federal,154,36,federal,OTHER
4830,4832,825,2257,879,2293,tax,54,36,tax,OTHER
4834,4839,886,2257,991,2294,return,105,37,return,OTHER
4841,4844,103,2296,161,2330,this,58,34,this,OTHER
4846,4856,167,2297,328,2330,information,161,33,information,OTHER
4858,4859,334,2298,361,2330,is,27,32,is,OTHER
4861,4865,367,2298,446,2330,being,79,32,being,OTHER
4867,4875,453,2299,585,2330,furnished,132,31,furnished,OTHER
4877,4878,591,2299,620,2331,to,29,32,to,OTHER
4880,4882,626,2299,675,2331,the,49,32,the,OTHER
4884,4891,681,2298,789,2331,internal,108,33,internal,OTHER
4893,4899,795,2298,926,2331,revenue,131,33,revenue,OTHER
4901,4908,931,2297,1044,2332,service.,113,35,service.,OTHER
