start_index,end_index,x_top_left,y_top_left,x_bottom_right,y_bottom_right,transcript,box_width,box_height,combined_text,predicted_field
0,0,944,1736,1032,1765,33094.23,88,29,33094.23,OTHER
0,0,874,2744,943,2771,w-2,69,27,w-2,OTHER
107,110,1035,253,1156,305,2018,121,52,2018,OTHER
131,133,1171,254,1275,306,w-2,104,52,w-2,OTHER
148,150,1287,255,1386,307,and,99,52,and,OTHER
164,171,1401,255,1690,307,earnings,289,52,earnings,OTHER
194,200,1708,253,1995,306,summary,287,53,summary,OTHER
258,260,2225,245,2311,291,adp,86,46,adp,OTHER
280,287,222,317,318,344,employee,96,27,employee,OTHER
300,308,391,313,498,346,reference,107,33,reference,OTHER
314,317,592,316,643,342,copy,51,26,copy,OTHER
360,362,964,314,1006,344,his,42,30,his,OTHER
364,367,1011,314,1070,343,blue,59,29,blue,OTHER
369,376,1077,314,1196,343,earnings,119,29,earnings,OTHER
378,384,1201,314,1328,342,summary,127,28,summary,OTHER
386,392,1333,314,1429,342,section,96,28,section,OTHER
394,395,1434,314,1458,342,is,24,28,is,OTHER
397,404,1464,314,1579,342,included,115,28,included,OTHER
406,409,1584,314,1639,342,with,55,28,with,OTHER
411,414,1644,314,1705,342,your,61,28,your,OTHER
416,418,1710,314,1767,342,w-2,57,28,w-2,OTHER
420,421,1773,314,1800,342,to,27,28,to,OTHER
423,426,1806,314,1864,343,help,58,29,help,OTHER
428,435,1876,313,1985,344,describe,109,31,describe,OTHER
437,444,1990,313,2097,344,portions,107,31,portions,OTHER
446,447,2103,313,2128,345,in,25,32,in,OTHER
449,452,2134,312,2206,346,more,72,34,more,OTHER
454,460,2216,312,2288,346,detail.,72,34,detail.,OTHER
492,495,329,351,384,376,wage,55,25,wage,OTHER
497,499,428,346,465,370,and,37,24,and,OTHER
501,503,506,346,544,372,tax,38,26,tax,OTHER
559,560,965,343,999,370,he,34,27,he,OTHER
562,568,1006,343,1107,370,reverse,101,27,reverse,OTHER
570,573,1114,343,1169,370,side,55,27,side,OTHER
575,582,1176,343,1289,370,includes,113,27,includes,OTHER
584,590,1294,343,1395,370,general,101,27,general,OTHER
592,602,1399,343,1547,370,information,148,27,information,OTHER
604,607,1553,343,1608,370,that,55,27,that,OTHER
609,611,1612,343,1660,370,you,48,27,you,OTHER
613,615,1666,343,1726,370,may,60,27,may,OTHER
617,620,1732,343,1786,370,also,54,27,also,OTHER
622,625,1792,343,1843,370,find,51,27,find,OTHER
627,634,1848,343,1946,370,helpful.,98,27,helpful.,OTHER
639,641,113,381,168,417,n-2,55,36,n-2,OTHER
666,674,324,371,405,396,statement,81,25,statement,OTHER
684,687,581,386,668,418,2018,87,32,2018,taxYear
690,693,100,432,135,458,copy,35,26,copy,OTHER
695,695,138,432,149,455,c,11,23,c,OTHER
697,699,151,431,172,454,for,21,23,for,OTHER
701,710,174,431,252,455,employee's,78,24,employee's,OTHER
712,719,253,432,322,460,records.,69,28,records.,OTHER
736,738,564,422,596,448,omb,32,26,omb,OTHER
740,742,600,422,626,448,no.,26,26,no.,OTHER
744,752,631,421,709,448,1545-0008,78,27,1545-0008,OTHER
795,796,1025,425,1048,455,1.,23,30,1.,OTHER
798,800,1052,425,1096,455,the,44,30,the,OTHER
802,810,1101,425,1212,455,following,111,30,following,OTHER
812,822,1216,424,1353,454,information,137,30,information,OTHER
824,831,1358,424,1448,455,reflects,90,31,reflects,OTHER
833,836,1452,424,1508,455,your,56,31,your,OTHER
838,842,1512,424,1564,455,final,52,31,final,OTHER
844,847,1568,424,1624,455,2018,56,31,2018,OTHER
849,851,1628,424,1676,455,pay,48,31,pay,OTHER
853,856,1680,424,1732,455,stub,52,31,stub,OTHER
858,861,1737,424,1790,455,plus,53,31,plus,OTHER
863,865,1795,424,1840,455,any,45,31,any,OTHER
867,877,1845,424,1991,456,adjustments,146,32,adjustments,OTHER
879,887,1996,424,2113,456,submitted,117,32,submitted,OTHER
889,890,2117,425,2150,456,by,33,31,by,OTHER
892,895,2154,425,2210,457,your,56,32,your,OTHER
897,905,2214,425,2337,457,employer.,123,32,employer.,OTHER
908,908,99,449,117,475,d,18,26,d,OTHER
910,916,129,449,184,475,control,55,26,control,OTHER
918,923,187,445,258,475,number,71,30,number,OTHER
925,929,306,450,349,486,dept.,43,36,dept.,OTHER
931,932,351,461,379,489,50,28,28,50,OTHER
959,966,614,449,679,480,emplover,65,31,emplover,OTHER
968,970,684,450,709,479,use,25,29,use,OTHER
972,975,714,452,753,484,only,39,32,only,OTHER
977,978,758,458,781,488,36,23,30,36,OTHER
980,986,96,475,174,503,9838482,78,28,9838482,OTHER
1027,1027,562,464,582,493,a,20,29,a,OTHER
1093,1097,1102,472,1146,499,gross,44,27,gross,OTHER
1099,1101,1150,468,1180,497,pay,30,29,pay,OTHER
1108,1115,1262,468,1334,493,48656.47,72,25,48656.47,OTHER
1138,1143,1638,467,1687,495,2531.7,49,28,2531.7,OTHER
1154,1161,1837,472,1898,499,ct.state,61,27,ct.state,OTHER
1163,1168,1902,472,1956,498,income,54,26,income,OTHER
1170,1172,1961,471,1986,497,tax,25,26,tax,OTHER
1176,1181,2079,467,2133,495,733.39,54,28,733.39,OTHER
1326,1328,1458,488,1480,515,tax,22,27,tax,OTHER
1330,1337,1483,485,1560,515,withheld,77,30,withheld,OTHER
1359,1361,1840,498,1866,518,box,26,20,box,OTHER
1363,1364,1868,498,1888,518,17,20,20,17,OTHER
1365,1370,1878,512,1938,536,income,60,24,income,OTHER
1556,1557,1890,499,1906,519,of,16,20,of,OTHER
1559,1561,1908,500,1943,520,w-2,35,20,w-2,OTHER
1562,1563,1938,515,1954,538,ta,16,23,ta,OTHER
1576,1580,180,514,214,543,yer's,34,29,yer's,OTHER
1582,1586,218,514,264,542,"name,",46,28,"name,",OTHER
1588,1595,268,514,334,541,"address,",66,27,"address,",OTHER
1597,1599,337,515,365,541,and,28,26,and,OTHER
1601,1603,368,515,394,541,zip,26,26,zip,OTHER
1605,1608,397,515,446,541,code,49,26,code,OTHER
1708,1710,1458,509,1482,537,box,24,28,box,OTHER
1712,1712,1485,509,1496,536,4,11,27,4,OTHER
1714,1715,1499,509,1513,535,of,14,26,of,OTHER
1717,1719,1516,509,1555,536,w-2,39,27,w-2,OTHER
1740,1744,1836,511,1876,534,local,40,23,local,OTHER
1760,1766,2071,511,2131,539,5621.39,60,28,5621.39,OTHER
1774,1780,150,537,252,567,"davies,",102,30,"davies,",employerName
1782,1787,254,535,343,563,wright,89,28,wright,employerName
1789,1791,347,535,396,562,and,49,27,and,employerName
1793,1798,400,535,488,564,garcia,88,29,garcia,employerName
1800,1804,491,536,562,568,group,71,32,group,employerName
1943,1945,1837,532,1865,561,box,28,29,box,OTHER
1947,1948,1868,531,1886,560,19,18,29,19,OTHER
1950,1951,1889,531,1904,560,of,15,29,of,OTHER
1953,1954,1907,533,1925,560,w-,18,27,w-,OTHER
1956,1956,1928,534,1940,561,2,12,27,2,OTHER
1964,1968,153,566,225,598,13526,72,32,13526,employerAddressStreet_name
1970,1973,229,566,291,596,beth,62,30,beth,employerAddressStreet_name
1975,1979,295,567,372,595,roads,77,28,roads,employerAddressStreet_name
2072,2075,1102,568,1132,595,fed.,30,27,fed.,OTHER
2077,2082,1136,568,1198,594,income,62,26,income,OTHER
2084,2090,1258,566,1312,590,5547.33,54,24,5547.33,OTHER
2100,2107,1453,567,1520,595,medicare,67,28,medicare,OTHER
2109,2111,1524,566,1550,593,tax,26,27,tax,OTHER
2120,2126,1669,566,1731,590,1096.75,62,24,1096.75,OTHER
2136,2146,154,592,306,622,gloriaville,152,30,gloriaville,employerAddressCity
2148,2149,345,597,372,624,ky,27,27,ky,employerAddressState
2151,2160,427,592,561,624,64716-5774,134,32,64716-5774,employerAddressZip
2241,2243,1100,592,1129,619,tax,29,27,tax,OTHER
2245,2252,1131,591,1198,618,withheld,67,27,withheld,OTHER
2271,2278,1454,592,1530,618,withheld,76,26,withheld,OTHER
2395,2397,1106,615,1129,642,box,23,27,box,OTHER
2399,2399,1133,617,1142,644,2,9,27,2,OTHER
2401,2402,1146,618,1160,644,of,14,26,of,OTHER
2404,2406,1164,618,1194,644,w-2,30,26,w-2,OTHER
2422,2424,1453,612,1481,642,box,28,30,box,OTHER
2426,2426,1484,616,1495,642,6,11,26,6,OTHER
2428,2429,1498,616,1513,643,of,15,27,of,OTHER
2431,2431,1516,616,1527,643,w,11,27,w,OTHER
2433,2433,1530,616,1535,643,-,5,27,-,OTHER
2435,2435,1537,614,1558,642,2,21,28,2,OTHER
2456,2458,1843,614,1865,640,box,22,26,box,OTHER
2460,2461,1869,613,1887,639,14,18,26,14,OTHER
2463,2464,1890,614,1905,642,of,15,28,of,OTHER
2466,2467,1908,616,1929,645,w-,21,29,w-,OTHER
2507,2511,407,683,475,712,batch,68,29,batch,OTHER
2535,2540,589,677,674,710,#02021,85,33,#02021,OTHER
2542,2544,98,728,128,754,eff,30,26,eff,OTHER
2546,2554,132,728,215,756,employees,83,28,employees,OTHER
2556,2559,218,728,256,756,name,38,28,name,OTHER
2561,2561,258,728,266,756,.,8,28,.,OTHER
2563,2569,269,727,330,756,address,61,29,address,OTHER
2571,2573,333,727,362,756,and,29,29,and,OTHER
2575,2577,365,726,390,755,zip,25,29,zip,OTHER
2579,2582,393,725,439,755,code,46,30,code,OTHER
2690,2691,1023,753,1047,781,2.,24,28,2.,OTHER
2693,2696,1053,753,1112,782,your,59,29,your,OTHER
2698,2702,1117,753,1188,782,gross,71,29,gross,OTHER
2704,2706,1193,754,1236,783,pay,43,29,pay,OTHER
2708,2710,1241,754,1290,783,was,49,29,was,OTHER
2712,2719,1295,754,1397,783,adjusted,102,29,adjusted,OTHER
2721,2722,1402,754,1430,783,as,28,29,as,OTHER
2724,2730,1435,753,1523,783,follows,88,30,follows,OTHER
2732,2733,1528,753,1552,783,to,24,30,to,OTHER
2735,2741,1557,753,1658,783,produce,101,30,produce,OTHER
2743,2746,1662,752,1717,783,your,55,31,your,OTHER
2748,2750,1722,752,1771,783,w-2,49,31,w-2,OTHER
2752,2760,1775,751,1893,783,statement,118,32,statement,OTHER
2769,2775,155,781,252,814,jeffrey,97,33,jeffrey,employeeName
2777,2783,295,782,389,811,daniels,94,29,daniels,employeeName
2792,2795,156,813,212,841,4419,56,28,4419,OTHER
2797,2800,219,812,278,841,gail,59,29,gail,OTHER
2802,2805,284,810,343,839,park,59,29,park,OTHER
2933,2938,1334,817,1389,844,"wages,",55,27,"wages,",OTHER
2940,2944,1394,816,1431,844,"tips,",37,28,"tips,",OTHER
2946,2949,1435,814,1465,842,othe,30,28,othe,OTHER
2954,2959,1581,814,1625,845,social,44,31,social,OTHER
2961,2965,1631,813,1674,843,secur,43,30,secur,OTHER
2968,2973,1680,813,1729,841,medica,49,28,medica,OTHER
2989,2996,1840,811,1897,844,ct.state,57,33,ct.state,OTHER
2998,3003,1902,810,1970,843,"wages,",68,33,"wages,",OTHER
3005,3011,1992,814,2051,844,timothy,59,30,timothy,OTHER
3013,3016,2056,814,2093,841,pass,37,27,pass,OTHER
3025,3028,154,839,211,871,port,57,32,port,OTHER
3030,3037,215,840,330,872,michaela,115,32,michaela,OTHER
3039,3040,374,842,409,873,ut,35,31,ut,OTHER
3042,3051,416,839,554,872,47142-8947,138,33,47142-8947,OTHER
3166,3177,1335,841,1433,869,compensation,98,28,compensation,OTHER
3328,3330,1334,857,1364,887,box,30,30,box,OTHER
3332,3332,1369,859,1375,887,1,6,28,1,OTHER
3334,3335,1380,859,1394,888,of,14,29,of,OTHER
3337,3337,1399,860,1407,888,w,8,28,w,OTHER
3339,3339,1413,860,1415,888,-,2,28,-,OTHER
3341,3341,1420,861,1436,888,2,16,27,2,OTHER
3349,3353,1583,840,1643,870,wages,60,30,wages,OTHER
3354,3358,1679,829,1742,860,wages,63,31,wages,OTHER
3384,3388,1839,840,1874,867,"tips,",35,27,"tips,",OTHER
3389,3390,1869,857,1886,886,16,17,29,16,OTHER
3391,3393,1878,841,1898,867,etc,20,26,etc,OTHER
3394,3395,1625,860,1639,892,of,14,32,of,OTHER
3397,3397,1643,860,1654,892,w,11,32,w,OTHER
3398,3398,1658,860,1660,891,-,2,31,-,OTHER
3604,3606,1578,861,1609,894,box,31,33,box,OTHER
3621,3625,1992,841,2031,869,local,39,28,local,OTHER
3627,3632,2035,839,2090,869,"wages,",55,30,"wages,",OTHER
3802,3804,1679,860,1708,891,box,29,31,box,OTHER
3806,3806,1613,860,1622,892,3,9,32,3,OTHER
3808,3809,1724,860,1740,890,of,16,30,of,OTHER
3811,3811,1744,860,1755,890,w,11,30,w,OTHER
3813,3813,1756,860,1761,890,-,5,30,-,OTHER
3815,3815,1664,860,1675,891,2,11,31,2,OTHER
3817,3819,1837,857,1866,885,box,29,28,box,OTHER
3821,3821,1711,860,1720,890,5,9,30,5,OTHER
3823,3824,1889,858,1904,888,of,15,30,of,OTHER
3828,3828,192,1495,196,1524,-,4,29,-,OTHER
3830,3830,1763,860,1780,890,2,17,30,2,OTHER
3855,3859,1991,865,2030,897,"tips,",39,32,"tips,",OTHER
3861,3863,2033,868,2053,898,etc,20,30,etc,OTHER
3865,3865,2057,870,2060,899,.,3,29,.,OTHER
3870,3879,135,905,216,931,emplover's,81,26,emplover's,OTHER
3881,3883,220,905,252,931,fed,32,26,fed,OTHER
3885,3886,255,905,271,931,id,16,26,id,OTHER
3888,3893,275,904,335,931,number,60,27,number,OTHER
3908,3917,435,903,521,932,employee's,86,29,employee's,OTHER
3919,3921,524,903,556,933,ssa,32,30,ssa,OTHER
3923,3932,558,905,658,943,number_180,100,38,number_180,ssnOfEmployee
3939,3948,149,924,257,955,25-2069906,108,31,25-2069906,einEmployerIdentificationNumber
4047,4052,1071,926,1140,961,tgross,69,35,tgross,OTHER
4054,4056,1145,926,1174,952,pay,29,26,pay,OTHER
4087,4094,1382,921,1450,946,48656.47,68,25,48656.47,OTHER
4102,4106,1587,925,1626,955,48656,39,30,48656,OTHER
4114,4121,1996,915,2059,945,48656.47,63,30,48656.47,OTHER
4139,4146,1686,921,1748,950,48656.47,62,29,48656.47,OTHER
4159,4166,1841,922,1906,949,48656.47,65,27,48656.47,OTHER
4211,4217,433,957,488,991,federal,55,34,federal,OTHER
4219,4224,491,960,546,992,income,55,32,income,OTHER
4226,4228,550,961,574,991,tax,24,30,tax,OTHER
4230,4233,578,962,606,990,with,28,28,with,OTHER
4235,4237,610,961,632,988,hel,22,27,hel,OTHER
4392,4395,1991,936,2035,964,7339,44,28,7339,OTHER
4402,4406,133,963,179,990,wages,46,27,wages,OTHER
4408,4408,182,963,188,989,",",6,26,",",OTHER
4410,4413,191,963,216,989,tips,25,26,tips,OTHER
4415,4415,218,963,225,989,",",7,26,",",OTHER
4417,4421,227,961,268,989,other,41,28,other,OTHER
4423,4426,271,960,308,988,comp,37,28,comp,OTHER
4428,4428,311,959,319,988,.,8,29,.,OTHER
4503,4506,1022,966,1057,993,less,35,27,less,OTHER
4508,4510,1061,965,1082,991,401,21,26,401,OTHER
4512,4514,1086,964,1106,990,(k),20,26,(k),OTHER
4516,4521,1110,962,1159,989,(d-box,49,27,(d-box,OTHER
4523,4524,1164,961,1183,987,2),19,26,2),OTHER
4566,4568,1579,961,1618,994,nia,39,33,nia,OTHER
4570,4574,1677,962,1737,1001,na733,60,39,na733,OTHER
4620,4626,1991,973,2053,1003,6547.33,62,30,6547.33,OTHER
4735,4742,1022,1000,1089,1026,reported,67,26,reported,OTHER
4744,4745,1907,860,1930,890,w-,23,30,w-,OTHER
4746,4746,1180,1674,1203,1708,2,23,34,2,OTHER
4748,4752,1126,994,1181,1024,wages,55,30,wages,OTHER
4797,4804,1581,995,1655,1025,40577.43,74,30,40577.43,OTHER
4805,4812,1679,989,1745,1023,10577.43,66,34,10577.43,OTHER
4832,4839,1837,991,1898,1023,20577.43,61,32,20577.43,OTHER
4852,4858,1992,991,2053,1023,40577.4,61,32,40577.4,OTHER
4865,4870,135,1019,178,1048,social,43,29,social,OTHER
4872,4879,182,1019,241,1047,security,59,28,security,OTHER
4881,4885,244,1016,297,1046,wages,53,30,wages,OTHER
4902,4907,435,1018,481,1049,social,46,31,social,OTHER
4909,4916,485,1019,542,1049,security,57,30,security,OTHER
4918,4920,546,1019,570,1049,tax,24,30,tax,OTHER
4922,4925,574,1019,602,1049,with,28,30,with,OTHER
4927,4929,605,1019,627,1049,hel,22,30,hel,OTHER
4938,4945,138,1089,199,1118,medicare,61,29,medicare,OTHER
4947,4951,203,1088,253,1113,wages,50,25,wages,OTHER
4953,4955,257,1088,284,1111,and,27,23,and,OTHER
4957,4960,288,1088,326,1110,tips,38,22,tips,OTHER
4976,4983,433,1089,502,1116,medicare,69,27,medicare,OTHER
4985,4987,504,1090,529,1117,tax,25,27,tax,OTHER
4989,4996,532,1091,607,1126,withhead,75,35,withhead,OTHER
4998,4998,609,1100,621,1129,?,12,29,?,OTHER
5038,5039,1023,1085,1046,1116,3.,23,31,3.,OTHER
5041,5048,1051,1085,1169,1116,employee,118,31,employee,OTHER
5050,5052,1175,1085,1222,1116,w-4,47,31,w-4,OTHER
5054,5061,1227,1085,1314,1116,profile.,87,31,profile.,OTHER
5063,5064,1319,1086,1348,1116,to,29,30,to,OTHER
5066,5071,1353,1086,1440,1116,change,87,30,change,OTHER
5073,5076,1445,1086,1502,1116,your,57,30,your,OTHER
5078,5085,1506,1086,1624,1116,employee,118,30,employee,OTHER
5087,5089,1628,1086,1676,1116,w-4,48,30,w-4,OTHER
5091,5097,1680,1086,1758,1117,profile,78,31,profile,OTHER
5099,5110,1762,1086,1906,1117,"information,",144,31,"information,",OTHER
5112,5115,1909,1086,1950,1117,file,41,31,file,OTHER
5117,5117,1953,1086,1970,1117,a,17,31,a,OTHER
5119,5121,1973,1086,2024,1117,new,51,31,new,OTHER
5123,5125,2029,1086,2076,1117,w-4,47,31,w-4,OTHER
5127,5130,2079,1086,2134,1117,with,55,31,with,OTHER
5132,5135,2137,1086,2194,1118,your,57,32,your,OTHER
5137,5143,2197,1086,2286,1118,payroll,89,32,payroll,OTHER
5145,5149,2288,1086,2359,1118,dept.,71,32,dept.,OTHER
5158,5162,152,1107,198,1133,37818,46,26,37818,OTHER
5164,5164,200,1107,207,1133,.,7,26,.,OTHER
5166,5167,208,1107,239,1133,91,31,26,91,OTHER
5209,5209,406,1145,425,1175,8,19,30,8,OTHER
5211,5219,437,1144,504,1175,allocated,67,31,allocated,OTHER
5221,5224,506,1145,549,1178,tips,43,33,tips,OTHER
5372,5377,1837,1150,1877,1180,social,40,30,social,OTHER
5379,5386,1882,1150,1936,1179,security,54,29,security,OTHER
5388,5392,1940,1152,1991,1177,numbe,51,25,numbe,OTHER
5408,5415,2090,1147,2142,1176,1-54-180,52,29,1-54-180,OTHER
5422,5429,151,1160,239,1191,33034.23,88,31,33034.23,OTHER
5475,5479,562,1166,607,1192,37818,45,26,37818,OTHER
5481,5481,611,1165,616,1191,.,5,26,.,OTHER
5483,5484,620,1165,643,1191,91,23,26,91,OTHER
5534,5540,1106,1171,1209,1203,jeffrey,103,32,jeffrey,OTHER
5542,5548,1260,1171,1360,1199,daniels,100,28,daniels,OTHER
5553,5564,132,1208,218,1236,verification,86,28,verification,OTHER
5566,5569,222,1208,260,1233,code,38,25,code,OTHER
5591,5591,413,1206,432,1234,0,19,28,0,OTHER
5593,5601,439,1207,521,1235,dependent,82,28,dependent,OTHER
5603,5606,523,1208,557,1235,care,34,27,care,OTHER
5608,5615,558,1208,619,1235,benefits,61,27,benefits,OTHER
5667,5670,1105,1205,1168,1237,4419,63,32,4419,OTHER
5672,5675,1174,1207,1240,1237,gail,66,30,gail,OTHER
5677,5680,1248,1208,1313,1236,park,65,28,park,OTHER
5752,5758,1834,1201,1906,1229,federal,72,28,federal,OTHER
5760,5760,1908,1199,1926,1228,:,18,29,:,OTHER
5879,5889,1101,1247,1266,1275,gloriaville,165,28,gloriaville,OTHER
5891,5892,1321,1248,1349,1267,ky,28,19,ky,OTHER
5920,5922,1410,1248,1450,1271,647,40,23,647,OTHER
5964,5968,1834,1233,1897,1268,local,63,35,local,OTHER
5972,5972,107,1266,124,1290,1,17,24,1,OTHER
5974,5985,137,1266,231,1290,nonqualified,94,24,nonqualified,OTHER
5987,5991,234,1265,274,1287,plans,40,22,plans,OTHER
6011,6012,413,1261,437,1288,2a,24,27,2a,OTHER
6014,6016,440,1262,467,1289,see,27,27,see,OTHER
6018,6029,470,1263,559,1290,instructions,89,27,instructions,OTHER
6031,6033,562,1263,584,1290,for,22,27,for,OTHER
6035,6037,587,1262,617,1289,box,30,27,box,OTHER
6039,6040,620,1261,637,1288,12,17,27,12,OTHER
6048,6050,153,1278,191,1306,224,38,28,224,OTHER
6054,6054,108,1326,122,1349,4,14,23,4,OTHER
6056,6060,142,1324,188,1349,other,46,25,other,OTHER
6094,6095,411,1349,443,1381,20,32,32,20,OTHER
6117,6119,562,1353,603,1386,434,41,33,434,OTHER
6154,6157,422,1386,443,1417,stat,21,31,stat,OTHER
6159,6162,447,1385,477,1418,emp.,30,33,emp.,OTHER
6164,6167,482,1385,497,1418,fist,15,33,fist,OTHER
6169,6169,501,1385,505,1418,.,4,33,.,OTHER
6171,6174,508,1383,547,1418,plan,39,35,plan,OTHER
6176,6178,559,1382,576,1417,ard,17,35,ard,OTHER
6180,6184,580,1380,609,1415,party,29,35,party,OTHER
6186,6189,612,1378,635,1412,sick,23,34,sick,OTHER
6191,6193,637,1376,662,1410,pay,25,34,pay,OTHER
6197,6201,138,1430,182,1452,state,44,22,state,OTHER
6203,6212,229,1427,305,1453,emplovers',76,26,emplovers',OTHER
6214,6218,309,1426,342,1453,state,33,27,state,OTHER
6220,6221,345,1426,360,1453,id,15,27,id,OTHER
6223,6225,363,1425,399,1453,no.,36,28,no.,OTHER
6250,6255,562,1434,614,1468,22313.,52,34,22313.,box16StateWagesTips
6257,6258,619,1436,631,1469,6:,12,33,6:,box16StateWagesTips
6261,6262,100,1484,123,1506,17,23,22,17,OTHER
6263,6266,152,1495,188,1524,1733,36,29,1733,box17StateIncomeTax
6268,6268,985,2572,991,2593,-,6,21,-,OTHER
6270,6271,200,1495,228,1524,39,28,29,39,box17StateIncomeTax
6292,6292,414,1481,435,1512,8,21,31,8,OTHER
6294,6298,445,1482,484,1514,local,39,32,local,OTHER
6300,6304,489,1484,532,1515,wanes,43,31,wanes,OTHER
6306,6306,537,1485,540,1515,.,3,30,.,OTHER
6308,6312,545,1485,576,1515,"tips,",31,30,"tips,",OTHER
6314,6316,582,1485,598,1514,etc,16,29,etc,OTHER
6318,6318,604,1485,622,1513,.,18,28,.,OTHER
6324,6328,140,1535,180,1570,local,40,35,local,OTHER
6330,6335,184,1534,241,1567,income,57,33,income,OTHER
6362,6369,444,1541,501,1574,locality,57,33,locality,OTHER
6371,6374,506,1545,556,1579,name,50,34,name,OTHER
6376,6382,564,1550,633,1586,timothy,69,36,timothy,OTHER
6384,6387,638,1556,675,1589,pass,37,33,pass,OTHER
6495,6498,1039,1557,1071,1588,2018,32,31,2018,OTHER
6500,6503,1077,1556,1111,1586,"adp,",34,30,"adp,",OTHER
6505,6507,1116,1556,1155,1586,llc,39,30,llc,OTHER
6511,6511,98,1678,119,1708,1,21,30,1,OTHER
6513,6517,132,1678,179,1707,wages,47,29,wages,OTHER
6519,6519,184,1678,187,1706,",",3,28,",",OTHER
6521,6524,192,1678,215,1705,tips,23,27,tips,OTHER
6526,6526,220,1678,223,1704,.,3,26,.,OTHER
6528,6532,228,1676,266,1704,other,38,28,other,OTHER
6534,6537,272,1673,306,1703,comp,34,30,comp,OTHER
6539,6539,312,1672,322,1701,.,10,29,.,OTHER
6549,6555,434,1673,489,1706,federal,55,33,federal,OTHER
6557,6562,493,1675,548,1707,income,55,32,income,OTHER
6564,6566,552,1676,574,1707,tax,22,31,tax,OTHER
6568,6573,578,1676,630,1707,withhe,52,31,withhe,OTHER
6595,6595,863,1675,891,1709,1,28,34,1,OTHER
6597,6601,901,1676,944,1708,wages,43,32,wages,OTHER
6603,6603,950,1677,953,1707,.,3,30,.,OTHER
6605,6608,959,1676,980,1706,tips,21,30,tips,OTHER
6610,6610,986,1676,991,1706,",",5,30,",",OTHER
6612,6616,997,1675,1033,1705,other,36,30,other,OTHER
6618,6621,1040,1674,1074,1704,comp,34,30,comp,OTHER
6623,6623,1079,1673,1085,1702,.,6,29,.,OTHER
6630,6630,1991,1675,2013,1707,2,22,32,2,OTHER
6632,6638,1209,1674,1261,1708,federal,52,34,federal,OTHER
6640,6645,1267,1675,1319,1708,income,52,33,income,OTHER
6647,6649,1325,1675,1345,1707,tax,20,32,tax,OTHER
6651,6658,1352,1673,1410,1706,withheld,58,33,withheld,OTHER
6695,6699,1714,1674,1759,1707,wages,45,33,wages,OTHER
6701,6701,1764,1677,1767,1707,.,3,30,.,OTHER
6703,6706,1772,1677,1795,1707,tips,23,30,tips,OTHER
6708,6708,1801,1677,1805,1707,",",4,30,",",OTHER
6710,6714,1811,1675,1847,1707,other,36,32,other,OTHER
6716,6719,1853,1672,1887,1705,comp,34,33,comp,OTHER
6721,6721,1892,1671,1897,1701,.,5,30,.,OTHER
6729,6729,907,2779,912,2806,2,5,27,2,OTHER
6731,6737,2021,1675,2074,1707,federal,53,32,federal,OTHER
6739,6744,2080,1675,2134,1706,income,54,31,income,OTHER
6746,6748,2140,1675,2159,1706,tax,19,31,tax,OTHER
6750,6757,2165,1674,2223,1706,withheld,58,32,withheld,OTHER
6764,6769,133,1722,179,1747,social,46,25,social,OTHER
6771,6778,182,1723,242,1747,security,60,24,security,OTHER
6780,6784,245,1721,292,1747,wages,47,26,wages,OTHER
6796,6796,405,1715,428,1753,4,23,38,4,OTHER
6798,6803,436,1715,479,1753,social,43,38,social,OTHER
6805,6812,486,1716,540,1752,security,54,36,security,OTHER
6814,6816,547,1717,568,1749,tax,21,32,tax,OTHER
6818,6821,575,1717,599,1747,with,24,30,with,OTHER
6823,6826,605,1716,639,1745,held,34,29,held,OTHER
6846,6851,903,1719,947,1748,social,44,29,social,OTHER
6854,6854,2001,2612,2022,2641,0,21,29,0,OTHER
6856,6856,1994,1715,2016,1749,4,22,34,4,OTHER
6857,6857,1211,1811,1224,1839,.,13,28,.,OTHER
6858,6859,1814,1737,1843,1764,23,29,27,23,OTHER
6955,6962,951,1719,1010,1746,security,59,27,security,OTHER
6964,6966,1013,1720,1041,1746,wad,28,26,wad,OTHER
6982,6987,1209,1716,1253,1754,social,44,38,social,OTHER
6989,6996,1258,1716,1314,1753,security,56,37,security,OTHER
6998,7000,1320,1715,1342,1749,tax,22,34,tax,OTHER
7002,7009,1348,1711,1411,1747,withheld,63,36,withheld,OTHER
7048,7053,1717,1720,1759,1749,social,42,29,social,OTHER
7055,7062,1764,1720,1823,1746,security,59,26,security,OTHER
7064,7066,1827,1721,1860,1744,wag,33,23,wag,OTHER
7083,7088,2023,1716,2067,1750,social,44,34,social,OTHER
7090,7097,2072,1717,2129,1750,security,57,33,security,OTHER
7099,7101,2134,1718,2155,1748,tax,21,30,tax,OTHER
7103,7109,2160,1716,2214,1746,withhel,54,30,withhel,OTHER
7117,7124,151,1737,236,1766,33094.23,85,29,33094.23,OTHER
7167,7170,562,1744,596,1771,2531,34,27,2531,OTHER
7172,7174,600,1743,624,1769,.71,24,26,.71,OTHER
7175,7176,612,1772,641,1807,75,29,35,75,OTHER
7216,7223,435,1759,500,1795,medicare,65,36,medicare,OTHER
7225,7227,507,1759,526,1796,tax,19,37,tax,OTHER
7229,7237,534,1761,605,1802,withhelds,71,41,withhelds,OTHER
7315,7318,1335,1742,1370,1770,2531,35,28,2531,OTHER
7320,7322,1374,1742,1400,1769,.71,26,27,.71,OTHER
7323,7324,1383,1768,1412,1803,75,29,35,75,OTHER
7445,7452,1208,1758,1270,1796,medicare,62,38,medicare,OTHER
7454,7456,1278,1759,1299,1795,tax,21,36,tax,OTHER
7458,7465,1306,1760,1376,1800,withheld,70,40,withheld,OTHER
7515,7520,1757,1739,1812,1765,33094.,55,26,33094.,OTHER
7522,7523,1815,2078,1845,2103,23,30,25,23,OTHER
7564,7567,2147,1737,2184,1771,2531,37,34,2531,OTHER
7569,7571,2186,1735,2216,1769,.71,30,34,.71,OTHER
7572,7573,2197,1770,2217,1804,75,20,34,75,OTHER
7581,7583,138,1773,150,1800,the,12,27,the,OTHER
7585,7590,154,1770,198,1800,gicare,44,30,gicare,OTHER
7592,7596,202,1766,251,1798,wanes,49,32,wanes,OTHER
7598,7600,255,1763,283,1796,and,28,33,and,OTHER
7602,7605,287,1760,326,1795,tips,39,35,tips,OTHER
7761,7768,1713,1763,1780,1795,medicare,67,32,medicare,OTHER
7770,7774,1785,1762,1834,1792,wages,49,30,wages,OTHER
7776,7778,1022,1766,1050,1798,and,28,32,and,OTHER
7780,7783,1054,1762,1084,1795,tips,30,33,tips,OTHER
7798,7805,2021,1762,2086,1797,medicare,65,35,medicare,OTHER
7807,7809,2092,1762,2113,1796,tax,21,34,tax,OTHER
7811,7818,2119,1763,2190,1801,withheld,71,38,withheld,OTHER
7911,7917,946,1770,1019,1805,3781gas,73,35,3781gas,OTHER
7919,7921,1839,1761,1863,1791,and,24,30,and,OTHER
7923,7926,1868,1760,1907,1791,tips,39,31,tips,OTHER
7928,7930,100,1818,124,1849,98;,24,31,98;,OTHER
7932,7938,130,1812,182,1845,control,52,33,control,OTHER
7940,7945,186,1808,256,1839,number,70,31,number,OTHER
7947,7951,307,1813,357,1840,dept.,50,27,dept.,OTHER
7953,7957,407,1806,444,1837,corp.,37,31,corp.,OTHER
7992,7999,615,1809,679,1838,employer,64,29,employer,OTHER
8001,8003,683,1809,709,1839,use,26,30,use,OTHER
8005,8008,713,1811,754,1843,only,41,32,only,OTHER
8038,8042,1100,1814,1152,1846,dept.,52,32,dept.,OTHER
8044,8047,1179,1811,1205,1840,corp,26,29,corp,OTHER
8049,8049,1383,2074,1390,2101,.,7,27,.,OTHER
8072,8079,1389,1806,1452,1838,employer,63,32,employer,OTHER
8081,8083,1457,1809,1483,1838,use,26,29,use,OTHER
8085,8088,1487,1807,1530,1838,only,43,31,only,OTHER
8140,8144,1913,1813,1965,1842,dept.,52,29,dept.,OTHER
8146,8150,1992,1808,2040,1840,corp.,48,32,corp.,OTHER
8174,8181,2200,1808,2266,1839,employer,66,31,employer,OTHER
8183,8185,2270,1810,2295,1842,use,25,32,use,OTHER
8187,8190,2299,1813,2338,1846,only,39,33,only,OTHER
8192,8193,2343,1818,2370,1851,36,27,33,36,OTHER
8281,8289,876,1812,953,1847,gacontrol,77,35,gacontrol,OTHER
8291,8296,956,1808,1026,1835,number,70,27,number,OTHER
8378,8387,1691,1812,1765,1849,agecontrol,74,37,agecontrol,OTHER
8389,8394,1769,1807,1833,1837,number,64,30,number,OTHER
8397,8397,100,1841,121,1872,"""",21,31,"""",OTHER
8399,8408,133,1843,215,1877,employer's,82,34,employer's,OTHER
8410,8414,218,1848,265,1879,"name,",47,31,"name,",OTHER
8416,8422,268,1849,324,1880,address,56,31,address,OTHER
8424,8424,327,1850,334,1880,",",7,30,",",OTHER
8426,8428,337,1850,364,1880,and,27,30,and,OTHER
8430,8432,367,1850,393,1880,zip,26,30,zip,OTHER
8434,8437,396,1849,447,1879,code,51,30,code,OTHER
8480,8489,902,1842,983,1876,employer's,81,34,employer's,OTHER
8491,8494,987,1847,1026,1878,name,39,31,name,OTHER
8496,8496,1030,1848,1033,1878,",",3,30,",",OTHER
8498,8504,1037,1849,1093,1879,address,56,30,address,OTHER
8506,8506,1096,1850,1102,1879,",",6,29,",",OTHER
8508,8510,1105,1850,1134,1879,and,29,29,and,OTHER
8512,8514,1137,1850,1163,1879,zip,26,29,zip,OTHER
8516,8519,1166,1849,1215,1879,code,49,30,code,OTHER
8578,8588,1680,1840,1796,1876,"""employer's",116,36,"""employer's",OTHER
8590,8594,1800,1847,1846,1878,"name,",46,31,"name,",OTHER
8596,8602,1850,1849,1907,1879,address,57,30,address,OTHER
8604,8604,1910,1850,1915,1879,",",5,29,",",OTHER
8606,8608,1919,1850,1947,1879,and,28,29,and,OTHER
8610,8612,1951,1849,1976,1878,zip,25,29,zip,OTHER
8614,8617,1979,1848,2022,1877,code,43,29,code,OTHER
8626,8632,152,1877,252,1906,"davies,",100,29,"davies,",OTHER
8634,8639,256,1876,343,1905,wright,87,29,wright,OTHER
8641,8643,348,1876,395,1904,and,47,28,and,OTHER
8645,8650,400,1876,486,1905,garcia,86,29,garcia,OTHER
8652,8656,491,1876,562,1906,group,71,30,group,OTHER
8711,8717,943,1872,1044,1903,"davies,",101,31,"davies,",OTHER
8719,8724,1047,1875,1137,1905,wright,90,30,wright,OTHER
8726,8728,1141,1877,1189,1905,and,48,28,and,OTHER
8730,8735,1192,1876,1280,1905,garcia,88,29,garcia,OTHER
8737,8741,1284,1874,1345,1905,group,61,31,group,OTHER
8810,8816,1758,1877,1858,1906,"davies,",100,29,"davies,",OTHER
8818,8823,1863,1876,1949,1905,wright,86,29,wright,OTHER
8825,8827,1955,1876,2001,1905,and,46,29,and,OTHER
8829,8834,2007,1875,2092,1905,garcia,85,30,garcia,OTHER
8836,8840,2098,1875,2158,1906,group,60,31,group,OTHER
8850,8854,154,1896,225,1932,13526,71,36,13526,OTHER
8856,8859,230,1900,289,1933,beth,59,33,beth,OTHER
8861,8865,295,1903,372,1933,roads,77,30,roads,OTHER
8935,8939,945,1905,1019,1937,13526,74,32,13526,OTHER
8941,8941,1022,1905,1039,1934,b,17,29,b,OTHER
9035,9039,1761,1902,1830,1934,13526,69,32,13526,OTHER
9041,9044,1835,1902,1896,1933,beth,61,31,beth,OTHER
9046,9050,1900,1903,1978,1933,roads,78,30,roads,OTHER
9060,9070,154,1930,308,1963,gloriaville,154,33,gloriaville,OTHER
9072,9073,345,1936,372,1967,ky,27,31,ky,OTHER
9075,9084,426,1935,561,1963,64716-5774,135,28,64716-5774,OTHER
9146,9156,945,1932,1096,1959,gloriaville,151,27,gloriaville,OTHER
9158,9159,1139,1936,1166,1968,ky,27,32,ky,OTHER
9161,9170,1218,1935,1353,1964,64716-5774,135,29,64716-5774,OTHER
9244,9254,1759,1931,1912,1962,gloriaville,153,31,gloriaville,OTHER
9256,9256,1951,1935,1972,1967,k,21,32,k,OTHER
9277,9286,2033,1934,2161,1963,64716-5774,128,29,64716-5774,OTHER
9294,9303,134,1996,215,2028,employer's,81,32,employer's,OTHER
9305,9307,220,1998,251,2028,fed,31,30,fed,OTHER
9309,9310,256,1999,271,2028,id,15,29,id,OTHER
9312,9317,275,1998,330,2028,number,55,30,number,OTHER
9328,9328,406,2000,426,2031,a,20,31,a,OTHER
9330,9339,436,1998,521,2030,employee's,85,32,employee's,OTHER
9341,9343,526,1998,556,2030,ssa,30,32,ssa,OTHER
9345,9350,561,1998,617,2032,number,56,34,number,OTHER
9377,9386,903,1999,983,2028,employer's,80,29,employer's,OTHER
9388,9390,987,1999,1020,2028,fed,33,29,fed,OTHER
9392,9393,1024,2000,1040,2029,id,16,29,id,OTHER
9395,9400,1044,2000,1103,2031,number,59,31,number,OTHER
9419,9428,1207,1997,1294,2031,employee's,87,34,employee's,OTHER
9430,9432,1299,1998,1329,2031,ssa,30,33,ssa,OTHER
9434,9439,1333,1999,1392,2030,number,59,31,number,OTHER
9475,9484,1715,1997,1798,2027,employer's,83,30,employer's,OTHER
9486,9488,1802,1999,1832,2028,fed,30,29,fed,OTHER
9490,9491,1836,2000,1852,2028,id,16,28,id,OTHER
9493,9498,1856,1999,1926,2028,number,70,29,number,OTHER
9515,9515,1994,1999,2015,2030,a,21,31,a,OTHER
9517,9526,2022,1998,2109,2031,employee's,87,33,employee's,OTHER
9528,9530,2113,1998,2143,2030,ssa,30,32,ssa,OTHER
9532,9537,2147,1996,2211,2030,number,64,34,number,OTHER
9546,9555,151,2017,259,2045,25-2059906,108,28,25-2059906,OTHER
9728,9737,1757,2020,1864,2046,25-2069906,107,26,25-2069906,OTHER
9744,9749,133,2061,178,2089,social,45,28,social,OTHER
9751,9758,182,2062,242,2089,security,60,27,security,OTHER
9760,9763,244,2062,271,2089,tips,27,27,tips,OTHER
9779,9779,406,2056,428,2089,8,22,33,8,OTHER
9781,9789,436,2056,501,2088,allocated,65,32,allocated,OTHER
9791,9794,506,2058,550,2089,tips,44,31,tips,OTHER
9831,9833,926,2066,947,2095,ial,21,29,ial,OTHER
9835,9842,949,2065,1010,2094,security,61,29,security,OTHER
9844,9846,1012,2065,1027,2093,tin,15,28,tin,OTHER
9867,9867,1180,2054,1203,2088,8,23,34,8,OTHER
9869,9877,1209,2055,1275,2088,allocated,66,33,allocated,OTHER
9879,9882,1281,2058,1325,2088,tips,44,30,tips,OTHER
9925,9930,1715,2059,1759,2088,social,44,29,social,OTHER
9932,9939,1765,2062,1823,2088,security,58,26,security,OTHER
9941,9943,1828,2063,1851,2088,tip,23,25,tip,OTHER
9966,9974,2023,2058,2089,2088,allocated,66,30,allocated,OTHER
9976,9979,2094,2057,2136,2087,tips,42,30,tips,OTHER
10042,10047,563,2074,616,2102,37818.,53,28,37818.,OTHER
10049,10050,620,2073,638,2099,91,18,26,91,OTHER
10128,10132,1334,2074,1380,2104,37818,46,30,37818,OTHER
10134,10134,2197,2076,2203,2102,.,6,26,.,OTHER
10136,10137,1393,2074,1421,2101,91,28,27,91,OTHER
10171,10176,1758,2077,1812,2103,33094.,54,26,33094.,OTHER
10178,10178,1719,2778,1726,2805,2,7,27,2,OTHER
10224,10228,2147,2077,2195,2103,37818,48,26,37818,OTHER
10230,10230,2089,2290,2089,2327,.,0,37,.,OTHER
10232,10233,2205,2075,2224,2102,91,19,27,91,OTHER
10238,10249,132,2116,218,2146,verification,86,30,verification,OTHER
10251,10254,222,2115,265,2146,code,43,31,code,OTHER
10275,10276,408,2117,432,2149,10,24,32,10,OTHER
10278,10286,438,2117,518,2149,dependent,80,32,dependent,OTHER
10288,10291,523,2118,554,2146,care,31,28,care,OTHER
10293,10299,559,2117,612,2145,benefit,53,28,benefit,OTHER
10323,10334,900,2117,985,2148,verification,85,31,verification,OTHER
10336,10339,989,2117,1027,2147,code,38,30,code,OTHER
10362,10363,1179,2114,1208,2147,10,29,33,10,OTHER
10365,10373,1212,2116,1293,2148,dependent,81,32,dependent,OTHER
10375,10378,1297,2118,1330,2148,care,33,30,care,OTHER
10380,10387,1334,2118,1388,2147,benefits,54,29,benefits,OTHER
10421,10432,1715,2118,1798,2148,verification,83,30,verification,OTHER
10434,10437,1803,2118,1836,2146,code,33,28,code,OTHER
10459,10460,1992,2115,2020,2146,10,28,31,10,OTHER
10462,10470,2026,2116,2107,2147,dependent,81,31,dependent,OTHER
10472,10475,2111,2117,2142,2147,care,31,30,care,OTHER
10477,10483,2146,2116,2198,2146,benefit,52,30,benefit,OTHER
10543,10545,1335,2133,1376,2164,171,41,31,171,OTHER
10630,10632,2150,2131,2190,2163,171,40,32,171,OTHER
10725,10727,564,2136,600,2162,171,36,26,171,OTHER
10730,10731,100,2177,126,2203,11,26,26,11,OTHER
10733,10744,136,2178,231,2205,nonqualified,95,27,nonqualified,OTHER
10746,10750,234,2178,282,2205,plans,48,27,plans,OTHER
10770,10771,414,2175,435,2207,za,21,32,za,OTHER
10773,10775,440,2176,465,2207,see,25,31,see,OTHER
10777,10788,471,2176,555,2206,instructions,84,30,instructions,OTHER
10790,10792,561,2176,582,2205,for,21,29,for,OTHER
10794,10796,587,2176,615,2205,box,28,29,box,OTHER
10798,10799,620,2175,637,2204,12,17,29,12,OTHER
10818,10829,904,2175,996,2205,nonqualified,92,30,nonqualified,OTHER
10831,10835,1001,2175,1048,2205,plans,47,30,plans,OTHER
10857,10859,1180,2176,1209,2206,12a,29,30,12a,OTHER
10861,10863,1213,2176,1238,2207,see,25,31,see,OTHER
10865,10876,1243,2176,1332,2207,instructions,89,31,instructions,OTHER
10878,10880,1336,2176,1356,2205,for,20,29,for,OTHER
10882,10884,1359,2175,1390,2205,box,31,30,box,OTHER
10886,10887,1393,2174,1413,2203,12,20,29,12,OTHER
10914,10925,1718,2175,1810,2206,nonqualified,92,31,nonqualified,OTHER
10927,10931,1816,2175,1868,2206,plans,52,31,plans,OTHER
10954,10955,2002,2178,2021,2207,2a,19,29,2a,OTHER
10957,10959,2025,2177,2053,2207,see,28,30,see,OTHER
10961,10972,2057,2175,2145,2207,instructions,88,32,instructions,OTHER
10974,10976,2149,2175,2169,2206,for,20,31,for,OTHER
10978,10980,2173,2175,2205,2206,box,32,31,box,OTHER
10982,10983,2208,2175,2227,2206,12,19,31,12,OTHER
10989,10991,153,2228,173,2249,the,20,21,the,OTHER
11069,11070,868,2233,891,2259,14,23,26,14,OTHER
11072,11075,910,2232,943,2256,othe,33,24,othe,OTHER
11170,11172,1724,2233,1753,2253,oth,29,20,oth,OTHER
11209,11210,402,2301,414,2336,13,12,35,13,OTHER
11212,11215,418,2300,442,2336,stat,24,36,stat,OTHER
11217,11220,446,2299,476,2336,emp.,30,37,emp.,OTHER
11222,11225,481,2298,504,2335,ret.,23,37,ret.,OTHER
11227,11230,509,2296,551,2335,plan,42,39,plan,OTHER
11232,11234,562,2294,577,2333,ard,15,39,ard,OTHER
11236,11241,583,2292,611,2332,partly,28,40,partly,OTHER
11243,11246,618,2290,638,2330,sick,20,40,sick,OTHER
11248,11250,645,2287,675,2328,pay,30,41,pay,OTHER
11300,11303,1211,2299,1247,2337,temp,36,38,temp,OTHER
11305,11308,1254,2298,1275,2337,ret.,21,39,ret.,OTHER
11310,11313,1282,2296,1325,2337,plan,43,41,plan,OTHER
11315,11317,1332,2295,1350,2335,ard,18,40,ard,OTHER
11319,11323,1357,2292,1385,2333,party,28,41,party,OTHER
11325,11328,1392,2290,1412,2331,sick,20,41,sick,OTHER
11330,11332,1419,2287,1445,2328,pay,26,41,pay,OTHER
11395,11396,1991,2286,2000,2323,13,9,37,13,OTHER
11398,11401,2007,2287,2029,2325,stat,22,38,stat,OTHER
11403,11405,2036,2288,2060,2326,emp,24,38,emp,OTHER
11407,11409,2067,2289,2082,2327,ret,15,38,ret,OTHER
11411,11411,1842,2337,1847,2366,.,5,29,.,OTHER
11413,11416,2096,2290,2139,2327,plan,43,37,plan,OTHER
11418,11420,2146,2291,2163,2327,ard,17,36,ard,OTHER
11422,11426,2170,2291,2196,2327,party,26,36,party,OTHER
11428,11431,2203,2291,2225,2326,sick,22,35,sick,OTHER
11433,11435,2232,2291,2256,2325,pay,24,34,pay,OTHER
11437,11439,98,2335,127,2362,eff,29,27,eff,OTHER
11441,11449,132,2336,215,2366,employees,83,30,employees,OTHER
11451,11455,218,2337,265,2366,name.,47,29,name.,OTHER
11457,11463,268,2335,330,2366,address,62,31,address,OTHER
11465,11467,332,2333,361,2364,and,29,31,and,OTHER
11469,11471,363,2331,391,2363,zip,28,32,zip,OTHER
11473,11476,393,2327,440,2361,code,47,34,code,OTHER
11521,11523,866,2336,897,2364,eff,31,28,eff,OTHER
11525,11533,901,2336,983,2366,employees,82,30,employees,OTHER
11535,11539,987,2337,1033,2366,name.,46,29,name.,OTHER
11541,11547,1036,2335,1098,2365,address,62,30,address,OTHER
11549,11551,1100,2334,1130,2364,and,30,30,and,OTHER
11553,11555,1132,2333,1158,2362,zip,26,29,zip,OTHER
11557,11560,1160,2331,1197,2361,code,37,30,code,OTHER
11619,11621,1679,2336,1710,2365,elf,31,29,elf,OTHER
11623,11631,1714,2336,1795,2366,employees,81,30,employees,OTHER
11633,11636,1799,2337,1838,2366,name,39,29,name,OTHER
11638,11638,1384,2511,1388,2539,.,4,28,.,OTHER
11640,11646,1851,2335,1910,2366,address,59,31,address,OTHER
11648,11650,1914,2334,1941,2365,and,27,31,and,OTHER
11652,11654,1945,2333,1971,2364,zip,26,31,zip,OTHER
11656,11659,1974,2330,2012,2362,code,38,32,code,OTHER
11668,11674,156,2381,252,2409,jeffrey,96,28,jeffrey,OTHER
11676,11682,296,2380,390,2408,daniels,94,28,daniels,OTHER
11754,11760,949,2382,1041,2407,jeffrey,92,25,jeffrey,OTHER
11762,11768,1088,2381,1178,2408,daniels,90,27,daniels,OTHER
11853,11859,1762,2382,1855,2409,jeffrey,93,27,jeffrey,OTHER
11861,11867,1902,2380,1997,2409,daniels,95,29,daniels,OTHER
11876,11879,154,2407,213,2438,4419,59,31,4419,OTHER
11881,11884,218,2405,278,2437,gail,60,32,gail,OTHER
11886,11889,282,2403,342,2434,park,60,31,park,OTHER
11962,11965,947,2406,1007,2438,4419,60,32,4419,OTHER
11967,11970,1011,2407,1072,2438,gail,61,31,gail,OTHER
11972,11975,1076,2405,1131,2435,park,55,30,park,OTHER
12060,12063,1760,2407,1820,2436,4419,60,29,4419,OTHER
12065,12068,1825,2407,1884,2436,gail,59,29,gail,OTHER
12070,12073,1889,2406,1948,2434,park,59,28,park,OTHER
12081,12084,152,2433,212,2464,port,60,31,port,OTHER
12086,12093,216,2432,332,2464,michaela,116,32,michaela,OTHER
12095,12096,374,2434,408,2463,ut,34,29,ut,OTHER
12098,12107,415,2434,549,2464,47142-8947,134,30,47142-8947,OTHER
12168,12171,945,2435,1005,2463,port,60,28,port,OTHER
12173,12180,1009,2434,1122,2462,michaela,113,28,michaela,OTHER
12182,12183,1167,2434,1201,2462,ut,34,28,ut,OTHER
12185,12194,1208,2432,1344,2462,47142-8947,136,30,47142-8947,OTHER
12267,12270,1760,2435,1817,2463,port,57,28,port,OTHER
12272,12279,1822,2433,1935,2463,michaela,113,30,michaela,OTHER
12281,12282,1979,2435,2014,2464,ut,35,29,ut,OTHER
12284,12293,2020,2431,2158,2464,47142-8947,138,33,47142-8947,OTHER
12297,12297,107,2503,122,2526,5,15,23,5,OTHER
12299,12303,138,2501,183,2531,state,45,30,state,OTHER
12311,12320,228,2503,305,2536,"""mplovers'",77,33,"""mplovers'",OTHER
12322,12326,308,2500,340,2530,state,32,30,state,OTHER
12328,12329,344,2500,360,2529,id,16,29,id,OTHER
12331,12333,363,2499,399,2528,no.,36,29,no.,OTHER
12335,12336,406,2498,433,2528,16,27,30,16,OTHER
12338,12342,445,2499,483,2528,state,38,29,state,OTHER
12344,12349,486,2499,538,2531,"wanes,",52,32,"wanes,",OTHER
12351,12355,541,2502,575,2533,"tips,",34,31,"tips,",OTHER
12357,12360,579,2505,618,2537,"elf,",39,32,"elf,",OTHER
12362,12363,621,2509,639,2540,63,18,31,63,OTHER
12380,12381,867,2501,890,2526,15,23,25,15,OTHER
12383,12387,906,2503,951,2534,state,45,31,state,OTHER
12401,12410,1021,2499,1098,2533,emplovers',77,34,emplovers',OTHER
12412,12416,1102,2498,1133,2529,state,31,31,state,OTHER
12418,12419,1138,2498,1149,2528,10,11,30,10,OTHER
12421,12422,1154,2497,1175,2528,no,21,31,no,OTHER
12424,12425,1180,2497,1206,2528,16,26,31,16,OTHER
12427,12431,1218,2498,1254,2529,state,36,31,state,OTHER
12433,12437,1259,2500,1301,2531,wades,42,31,wades,OTHER
12439,12439,1307,2503,1309,2532,",",2,29,",",OTHER
12441,12445,1315,2504,1349,2535,tips.,34,31,tips.,OTHER
12447,12449,1354,2507,1378,2538,313,24,31,313,OTHER
12451,12451,2120,2501,2125,2532,.,5,31,.,OTHER
12453,12454,1394,2512,1408,2541,63,14,29,63,OTHER
12477,12478,1679,2501,1707,2528,15,28,27,15,OTHER
12480,12484,1718,2502,1765,2535,state,47,33,state,OTHER
12497,12506,1835,2499,1910,2532,emplovers',75,33,emplovers',OTHER
12508,12512,1914,2498,1946,2529,state,32,31,state,OTHER
12514,12515,1951,2497,1963,2528,id,12,31,id,OTHER
12517,12518,1968,2497,1988,2528,no,20,31,no,OTHER
12520,12521,1992,2497,2020,2529,16,28,32,16,OTHER
12523,12527,2030,2497,2068,2530,state,38,33,state,OTHER
12529,12533,2072,2499,2115,2532,wanes,43,33,wanes,OTHER
12535,12535,1308,2558,1312,2587,.,4,29,.,OTHER
12537,12541,2129,2502,2161,2535,tips.,32,33,tips.,OTHER
12543,12544,2165,2504,2183,2536,of,18,32,of,OTHER
12546,12546,2188,2506,2200,2538,;,12,32,;,OTHER
12548,12549,2205,2508,2219,2539,63,14,31,63,OTHER
12552,12553,102,2556,123,2581,17,21,25,17,OTHER
12555,12559,142,2559,180,2585,state,38,26,state,OTHER
12561,12566,182,2558,239,2585,income,57,27,income,OTHER
12568,12570,241,2556,267,2583,tax,26,27,tax,OTHER
12592,12592,412,2554,435,2585,8,23,31,8,OTHER
12594,12598,442,2555,483,2586,local,41,31,local,OTHER
12600,12605,486,2556,540,2587,wanes.,54,31,wanes.,OTHER
12607,12611,544,2558,576,2587,tips.,32,29,tips.,OTHER
12613,12616,580,2560,623,2587,etc.,43,27,etc.,OTHER
12678,12679,1178,2553,1210,2586,18,32,33,18,OTHER
12681,12685,1216,2554,1257,2586,local,41,32,local,OTHER
12687,12691,1261,2556,1304,2587,wades,43,31,wades,OTHER
12693,12693,1344,2560,1348,2588,.,4,28,.,OTHER
12695,12698,1316,2559,1340,2587,tips,24,28,tips,OTHER
12700,12700,2159,2558,2165,2588,.,6,30,.,OTHER
12702,12705,1352,2561,1399,2589,etc.,47,28,etc.,OTHER
12733,12734,1681,2556,1704,2581,17,23,25,17,OTHER
12736,12740,1724,2557,1762,2584,state,38,27,state,OTHER
12742,12747,1764,2558,1821,2586,income,57,28,income,OTHER
12749,12751,1822,2559,1841,2586,tax,19,27,tax,OTHER
12778,12779,1994,2555,2020,2585,18,26,30,18,OTHER
12781,12785,2030,2554,2070,2585,local,40,31,local,OTHER
12787,12791,2074,2554,2119,2586,wages,45,32,wages,OTHER
12793,12793,2123,2556,2127,2586,",",4,30,",",OTHER
12795,12798,2130,2556,2155,2587,tips,25,31,tips,OTHER
12800,12800,190,2627,196,2654,.,6,27,.,OTHER
12802,12805,2168,2559,2210,2590,etc.,42,31,etc.,OTHER
12900,12903,944,2571,984,2595,1733,40,24,1733,OTHER
12907,12908,992,2572,1023,2598,39,31,26,39,OTHER
12912,12913,101,2616,126,2643,19,25,27,19,OTHER
12915,12918,152,2626,187,2654,$621,35,28,$621,OTHER
12928,12928,141,2615,155,2641,l,14,26,l,OTHER
12932,12933,199,2626,230,2654,39,31,28,39,OTHER
12965,12966,409,2615,433,2642,20,24,27,20,OTHER
12968,12975,443,2615,502,2644,locality,59,29,locality,OTHER
12977,12980,505,2616,558,2647,name,53,31,name,OTHER
13011,13017,946,2625,1024,2654,5621.39,78,29,5621.39,OTHER
13044,13045,1179,2612,1206,2641,20,27,29,20,OTHER
13047,13054,1217,2614,1276,2644,locality,59,30,locality,OTHER
13056,13059,1279,2616,1331,2646,name,52,30,name,OTHER
13103,13104,1681,2615,1707,2644,19,26,29,19,OTHER
13106,13110,1723,2619,1763,2648,local,40,29,local,OTHER
13112,13118,1765,2622,1822,2650,"income,",57,28,"income,",OTHER
13120,13121,1824,2625,1838,2650,ta,14,25,ta,OTHER
13150,13157,2028,2614,2089,2646,locality,61,32,locality,OTHER
13159,13162,2092,2619,2145,2652,name,53,33,name,OTHER
13164,13170,2149,2625,2221,2660,timothy,72,35,timothy,OTHER
13172,13175,638,2633,673,2662,pass,35,29,pass,OTHER
13240,13246,563,2632,635,2662,timothy,72,30,timothy,OTHER
13248,13251,2223,2634,2262,2665,pass,39,31,pass,OTHER
13316,13322,1335,2633,1407,2658,timothy,72,25,timothy,OTHER
13324,13327,1410,2635,1454,2660,pass,44,25,pass,OTHER
13348,13354,229,2677,315,2705,federal,86,28,federal,OTHER
13374,13379,416,2681,468,2706,filing,52,25,filing,OTHER
13395,13398,592,2678,643,2703,copy,51,25,copy,OTHER
13434,13441,1017,2675,1111,2707,ct.state,94,32,ct.state,OTHER
13455,13460,1189,2683,1238,2705,filing,49,22,filing,OTHER
13471,13474,1367,2675,1414,2702,copy,47,27,copy,OTHER
13530,13533,1812,2675,1851,2706,city,39,31,city,OTHER
13535,13536,1855,2675,1875,2705,or,20,30,or,OTHER
13538,13542,1879,2675,1946,2713,local,67,38,local,OTHER
13544,13549,2002,2681,2055,2708,filing,53,27,filing,OTHER
13569,13572,2178,2677,2229,2700,copy,51,23,copy,OTHER
13606,13609,325,2706,388,2734,wage,63,28,wage,OTHER
13611,13613,426,2702,468,2725,and,42,23,and,OTHER
13615,13617,505,2706,539,2728,tax,34,22,tax,OTHER
13697,13699,1197,2700,1239,2729,and,42,29,and,OTHER
13701,13703,1277,2703,1311,2728,tax,34,25,tax,OTHER
13785,13788,1921,2705,1984,2734,wage,63,29,wage,OTHER
13790,13792,2011,2702,2052,2732,and,41,30,and,OTHER
13794,13796,2090,2704,2129,2726,tax,39,22,tax,OTHER
13830,13838,319,2731,417,2756,statement,98,25,statement,OTHER
13861,13864,581,2741,667,2774,2018,86,33,2018,OTHER
13882,13884,1094,999,1121,1026,w-2,27,27,w-2,OTHER
13913,13920,1110,2731,1203,2758,tatement,93,27,tatement,OTHER
13939,13942,1357,2740,1442,2772,2018,85,32,2018,OTHER
13982,13984,106,2742,174,2771,w-2,68,29,w-2,OTHER
14008,14016,1911,2729,2011,2753,statement,100,24,statement,OTHER
14036,14039,2166,2742,2254,2774,2018,88,32,2018,OTHER
14043,14045,1686,2741,1754,2773,w-2,68,32,w-2,OTHER
14048,14051,99,2779,132,2806,copy,33,27,copy,OTHER
14053,14053,137,2780,148,2807,b,11,27,b,OTHER
14055,14056,153,2780,164,2807,to,11,27,to,OTHER
14058,14059,169,2780,185,2807,be,16,27,be,OTHER
14061,14065,190,2781,217,2807,filed,27,26,filed,OTHER
14067,14070,222,2781,250,2807,with,28,26,with,OTHER
14072,14081,256,2781,330,2807,employee's,74,26,employee's,OTHER
14083,14089,335,2781,385,2806,federal,50,25,federal,OTHER
14091,14096,390,2781,442,2806,income,52,25,income,OTHER
14098,14100,447,2780,469,2804,tax,22,24,tax,OTHER
14102,14107,473,2779,520,2804,return,47,25,return,OTHER
14109,14111,562,2779,596,2810,omb,34,31,omb,OTHER
14113,14115,600,2778,625,2806,no.,25,28,no.,OTHER
14117,14125,630,2778,708,2805,1545-0008,78,27,1545-0008,OTHER
14131,14134,867,2779,902,2807,copy,35,28,copy,OTHER
14138,14139,917,2778,929,2806,to,12,28,to,OTHER
14141,14142,934,2778,951,2806,be,17,28,be,OTHER
14144,14148,956,2778,984,2807,filed,28,29,filed,OTHER
14150,14150,989,2780,998,2808,w,9,28,w,OTHER
14155,14159,1062,2780,1097,2808,yee's,35,28,yee's,OTHER
14161,14165,1101,2780,1136,2807,state,35,27,state,OTHER
14167,14172,1140,2779,1192,2806,income,52,27,income,OTHER
14174,14176,1196,2779,1220,2805,tax,24,26,tax,OTHER
14178,14183,1225,2779,1270,2804,return,45,25,return,OTHER
14185,14187,1334,2777,1369,2809,ome,35,32,ome,OTHER
14189,14191,1373,2775,1399,2805,no.,26,30,no.,OTHER
14193,14201,1403,2775,1474,2807,1545-0008,71,32,1545-0008,OTHER
14229,14232,1680,2778,1714,2805,copy,34,27,copy,OTHER
14236,14237,1731,2778,1742,2806,to,11,28,to,OTHER
14239,14240,1747,2779,1763,2806,be,16,27,be,OTHER
14242,14246,1768,2779,1797,2807,filed,29,28,filed,OTHER
14248,14251,1802,2780,1830,2807,with,28,27,with,OTHER
14264,14265,1987,2782,2000,2804,al,13,22,al,OTHER
14267,14272,2002,2782,2056,2806,income,54,24,income,OTHER
14274,14276,2058,2781,2084,2807,tax,26,26,tax,OTHER
14278,14283,2086,2780,2138,2807,return,52,27,return,OTHER
14285,14287,2147,2779,2183,2807,omb,36,28,omb,OTHER
14289,14291,2185,2779,2213,2807,no.,28,28,no.,OTHER
14293,14301,2215,2777,2296,2807,1545-0008,81,30,1545-0008,OTHER
